Year,Name,Position,Age,Club Name,League Name,Matches Played,Goals,Assists,Points
1974,Gerd Müller,Centre-Forward,28,Bayern Munich,Bundesliga,33,23,13,36
1974,Jupp Heynckes,Centre-Forward,29,Bor. M'gladbach,Bundesliga,31,27,4,31
1974,Delio Onnis,Centre-Forward,26,Monaco,Ligue 1,37,30,0,30
1974,Dieter Müller,Centre-Forward,20,1.FC Köln,Bundesliga,34,24,4,28
1974,Willi Lippens,Left Winger,28,RW Essen,3. Liga,34,15,11,26
1974,Allan Simonsen,Second Striker,21,Bor. M'gladbach,Bundesliga,34,18,4,22
1974,François M'Pelé,Centre-Forward,26,Paris SG,Ligue 1,37,21,0,21
1974,Roland Sandberg,Centre-Forward,27,1.FC K'lautern,2. Bundesliga,34,20,1,21
1974,Manfred Burgsmüller,Attacking Midfield,24,RW Essen,3. Liga,34,18,3,21
1974,Jürgen Grabowski,Right Winger,29,E. Frankfurt,Bundesliga,33,13,8,21
1974,Erwin Kostedde,Centre-Forward,28,K. Offenbach,Regionalliga Südwest,31,18,2,20
1974,Bernd Hölzenbein,Attacking Midfield,28,E. Frankfurt,Bundesliga,33,16,4,20
1974,Bernd Gersdorff,Attacking Midfield,27,E. Braunschweig,2. Bundesliga,34,15,5,20
1974,Hugo Curioni,Centre-Forward,27,FC Metz,Ligue 1,32,19,0,19
1974,Paolo Pulici,Centre-Forward,24,AC Torino,Serie A,23,18,1,19
1974,Klaus Fischer,Centre-Forward,24,FC Schalke 04,2. Bundesliga,33,17,2,19
1974,Dieter Herzog,Left Winger,27,F. Düsseldorf,2. Bundesliga,33,8,11,19
1974,Henning Jensen,Centre-Forward,24,Bor. M'gladbach,Bundesliga,34,13,5,18
1974,Gérard Tonnel,Centre-Forward,26,Troyes AF,Ligue 2,36,17,0,17
1974,Marc Berdoll,Centre-Forward,21,Angers SCO,Ligue 2,36,17,0,17
1974,Nico Braun,Centre-Forward,23,FC Metz,Ligue 1,34,17,0,17
1974,Bernard Lacombe,Centre-Forward,21,Olympique Lyon,Ligue 1,27,17,0,17
1974,Hermann Ohlicher,Attacking Midfield,24,VfB Stuttgart,Bundesliga,34,17,0,17
1974,Santillana,Centre-Forward,21,Real Madrid,LaLiga,32,17,0,17
1974,Reiner Geye,Right Winger,24,F. Düsseldorf,2. Bundesliga,33,15,2,17
1974,Werner Balte,Attacking Midfield,26,VfL Bochum,Bundesliga,34,14,3,17
1974,Norbert Janzon,Right Winger,23,K. Offenbach,Regionalliga Südwest,34,12,5,17
1974,Hannes Löhr,Left Winger,31,1.FC Köln,Bundesliga,33,11,6,17
1974,Bosko Antić,Left Winger,29,Angers SCO,Ligue 2,31,16,0,16
1974,José Eulogio Gárate,Centre-Forward,29,Atlético Madrid,LaLiga,32,16,0,16
1974,Christian Coste,Attack,25,LOSC Lille,Ligue 1,37,16,0,16
1974,Paulo César,Central Midfield,25,Marseille,Ligue 1,31,16,0,16
1974,Bernd Nickel,Attacking Midfield,25,E. Frankfurt,Bundesliga,34,11,5,16
1974,Nestor Combin,Centre-Forward,33,AS Red Star,Championnat National,31,15,0,15
1974,Carlos Bianchi,Centre-Forward,25,Stade Reims,Ligue 1,16,15,0,15
1974,Roberto Martínez,Centre-Forward,27,Real Madrid,LaLiga,27,15,0,15
1974,Giuseppe Savoldi,Centre-Forward,27,Bologna,Serie A,28,15,0,15
1974,Sergio Clerici,Centre-Forward,33,Napoli,Serie A,29,14,1,15
1974,Giorgio Chinaglia,Centre-Forward,27,Lazio,Serie A,30,14,1,15
1974,Heinz Flohe,Attacking Midfield,26,1.FC Köln,Bundesliga,28,7,8,15
1974,Hervé Revelli,Centre-Forward,28,Saint-Étienne,Ligue 2,35,14,0,14
1974,Serge Chiesa,Attacking Midfield,23,Olympique Lyon,Ligue 1,31,14,0,14
1974,Pierino Prati,Centre-Forward,27,AS Roma,Serie A,29,14,0,14
1974,Laurent Pokou,Attack,26,Stade Rennais,Ligue 1,27,14,0,14
1974,Norbert Stolzenburg,Centre-Forward,22,TeBe Berlin,NOFV-Oberliga Nord,33,13,1,14
1974,Mustapha Dahleb,Left Winger,22,Paris SG,Ligue 1,29,13,0,13
1974,Romain Argyroudis,Attack,27,Lens,Ligue 1,34,13,0,13
1974,Stanislav Karasi,Attack,27,LOSC Lille,Ligue 1,37,13,0,13
1974,Jacky Vergnes,Centre-Forward,25,SEC Bastia,Ligue 2,29,13,0,13
1974,Wolfgang Seel,Centre-Forward,26,F. Düsseldorf,2. Bundesliga,34,13,0,13
1975,Carlos Bianchi,Centre-Forward,26,Stade Reims,Ligue 1,38,34,0,34
1975,Delio Onnis,Centre-Forward,27,Monaco,Ligue 1,33,29,0,29
1975,Klaus Fischer,Centre-Forward,25,FC Schalke 04,2. Bundesliga,34,29,0,29
1975,Hugo Curioni,Centre-Forward,28,FC Metz,Ligue 1,37,25,0,25
1975,Gerd Müller,Centre-Forward,29,Bayern Munich,Bundesliga,22,23,1,24
1975,Erich Beer,Attacking Midfield,28,Hertha BSC,2. Bundesliga,34,23,1,24
1975,Michel Platini,Attacking Midfield,20,AS Nancy,Championnat National,31,22,0,22
1975,Klaus Toppmöller,Centre-Forward,23,1.FC K'lautern,2. Bundesliga,32,22,0,22
1975,Quini,Centre-Forward,25,Sporting Gijón,LaLiga2,34,21,0,21
1975,Robert Pintenat,Centre-Forward,27,FC Sochaux,Championnat National,38,21,0,21
1975,Paolo Pulici,Centre-Forward,25,AC Torino,Serie A,29,21,0,21
1975,Héctor Yazalde,Centre-Forward,29,Marseille,Ligue 1,31,19,0,19
1975,Christian Coste,Attack,26,LOSC Lille,Ligue 1,31,19,0,19
1975,Aitor Aguirre,Attack,25,Racing,LaLiga2,34,18,0,18
1975,Serge Chiesa,Attacking Midfield,24,Olympique Lyon,Ligue 1,36,18,0,18
1975,Horst Hrubesch,Centre-Forward,24,RW Essen,3. Liga,22,18,0,18
1975,Roland Sandberg,Centre-Forward,28,1.FC K'lautern,2. Bundesliga,34,17,0,17
1975,Bernd Hölzenbein,Attacking Midfield,29,E. Frankfurt,Bundesliga,34,16,1,17
1975,Bernd Nickel,Attacking Midfield,26,E. Frankfurt,Bundesliga,33,15,2,17
1975,Wolfgang Frank,Centre-Forward,24,E. Braunschweig,2. Bundesliga,34,16,0,16
1975,Gilles Rampillon,Attacking Midfield,21,FC Nantes,Ligue 1,33,16,0,16
1975,Allan Simonsen,Second Striker,22,Bor. M'gladbach,Bundesliga,34,16,0,16
1975,Nico Braun,Centre-Forward,24,FC Metz,Ligue 1,31,16,0,16
1975,Francesco Graziani,Centre-Forward,22,AC Torino,Serie A,28,15,1,16
1975,Manfred Burgsmüller,Attacking Midfield,25,RW Essen,3. Liga,30,14,2,16
1975,Hannes Löhr,Left Winger,32,1.FC Köln,Bundesliga,30,15,0,15
1975,Jacques Zimako,Left Winger,23,SEC Bastia,Ligue 2,35,15,0,15
1975,Gérard Soler,Centre-Forward,21,FC Sochaux,Championnat National,34,15,0,15
1975,Roberto Bettega,Centre-Forward,24,Juventus,Serie A,28,15,0,15
1975,Joachim Marx,Centre-Forward,30,Lens,Ligue 1,26,15,0,15
1975,Egidio Calloni,Centre-Forward,22,Milan,Serie A,25,13,2,15
1975,Jupp Heynckes,Centre-Forward,30,Bor. M'gladbach,Bundesliga,24,12,3,15
1975,Luciano Chiarugi,Left Winger,28,Milan,Serie A,23,7,8,15
1975,Erwin Kostedde,Centre-Forward,29,Hertha BSC,2. Bundesliga,26,14,0,14
1975,Giuseppe Savoldi,Centre-Forward,28,Napoli,Serie A,28,14,0,14
1975,Dieter Müller,Centre-Forward,21,1.FC Köln,Bundesliga,19,14,0,14
1975,Bernd Gersdorff,Attacking Midfield,28,E. Braunschweig,2. Bundesliga,29,13,1,14
1975,Ronald Worm,Centre-Forward,21,MSV Duisburg,3. Liga,31,12,2,14
1975,Pirri,Defensive Midfield,30,Real Madrid,LaLiga,31,13,0,13
1975,Rüdiger Wenzel,Centre-Forward,22,E. Frankfurt,Bundesliga,33,13,0,13
1975,Alain Giresse,Attacking Midfield,22,G. Bordeaux,Ligue 2,30,13,0,13
1975,Santillana,Centre-Forward,22,Real Madrid,LaLiga,30,12,0,12
1975,Hervé Revelli,Centre-Forward,29,Saint-Étienne,Ligue 2,29,12,0,12
1975,Cheikh Diallo,Attack,24,Troyes AF,Ligue 2,28,12,0,12
1975,Mustapha Dahleb,Left Winger,23,Paris SG,Ligue 1,32,12,0,12
1975,Johan Neeskens,Central Midfield,23,Barcelona,LaLiga,32,12,0,12
1975,Josef Kaczor,Centre-Forward,22,VfL Bochum,Bundesliga,27,12,0,12
1975,Henri Michel,Defensive Midfield,27,FC Nantes,Ligue 1,38,12,0,12
1975,François M'Pelé,Centre-Forward,27,Paris SG,Ligue 1,37,12,0,12
1975,Christian-Jacques Castellan,Attack,29,Ol. Avignon,France,36,12,0,12
1976,Dieter Müller,Centre-Forward,22,1.FC Köln,Bundesliga,34,34,0,34
1976,Gerd Müller,Centre-Forward,30,Bayern Munich,Bundesliga,25,28,3,31
1976,Carlos Bianchi,Centre-Forward,27,Stade Reims,Ligue 1,37,28,0,28
1976,Bernd Hölzenbein,Attacking Midfield,30,E. Frankfurt,Bundesliga,30,26,0,26
1976,Michel Platini,Attacking Midfield,21,AS Nancy,Championnat National,38,25,0,25
1976,Wolfgang Frank,Centre-Forward,25,E. Braunschweig,2. Bundesliga,32,24,0,24
1976,Mario Kempes,Centre-Forward,21,Valencia,LaLiga,34,24,0,24
1976,Klaus Fischer,Centre-Forward,26,FC Schalke 04,2. Bundesliga,31,24,0,24
1976,Nico Braun,Centre-Forward,25,FC Metz,Ligue 1,36,23,0,23
1976,Mustapha Dahleb,Left Winger,24,Paris SG,Ligue 1,38,22,0,22
1976,Manolo Clares,Attack,28,Barcelona,LaLiga,32,22,0,22
1976,Hugo Curioni,Centre-Forward,29,FC Metz,Ligue 1,37,22,0,22
1976,Francesco Graziani,Centre-Forward,23,AC Torino,Serie A,30,21,1,22
1976,Dragan Dzajic,Left Winger,30,SEC Bastia,Ligue 2,35,21,0,21
1976,François Félix,Centre-Forward,27,SEC Bastia,Ligue 2,38,21,0,21
1976,Bernard Lacombe,Centre-Forward,23,Olympique Lyon,Ligue 1,36,21,0,21
1976,Josef Kaczor,Centre-Forward,23,VfL Bochum,Bundesliga,34,21,0,21
1976,Horst Hrubesch,Centre-Forward,25,RW Essen,3. Liga,26,20,0,20
1976,Rüdiger Wenzel,Centre-Forward,23,E. Frankfurt,Bundesliga,34,20,0,20
1976,Benny Wendt,Centre-Forward,25,TeBe Berlin,NOFV-Oberliga Nord,30,20,0,20
1976,Jesús Satrustegui,Centre-Forward,22,Real Sociedad,LaLiga,33,19,0,19
1976,Nenad Bjekovic,Second Striker,28,OGC Nice,Ligue 1,32,19,0,19
1976,Rubén Cano,Centre-Forward,25,Atlético Madrid,LaLiga,33,19,0,19
1976,Jacky Vergnes,Centre-Forward,27,Stade Lavallois,Ligue 2,36,19,0,19
1976,Klaus Toppmöller,Centre-Forward,24,1.FC K'lautern,2. Bundesliga,34,19,0,19
1976,Roberto Pruzzo,Centre-Forward,21,Genoa,Serie A,30,18,1,19
1976,André Barthélemy,Attack,22,Angers SCO,Ligue 2,37,18,0,18
1976,Roberto Bettega,Centre-Forward,25,Juventus,Serie A,29,17,1,18
1976,Norbert Janzon,Right Winger,25,Karlsruher SC,2. Bundesliga,34,16,2,18
1976,Giuseppe Savoldi,Centre-Forward,29,Napoli,Serie A,28,16,1,17
1976,Lobo Diarte,Centre-Forward,22,Valencia,LaLiga,27,16,0,16
1976,Alain Giresse,Attacking Midfield,23,G. Bordeaux,Ligue 2,37,16,0,16
1976,Paolo Pulici,Centre-Forward,26,AC Torino,Serie A,29,16,0,16
1976,Omar Sahnoun,Attacking Midfield,20,FC Nantes,Ligue 1,31,15,0,15
1976,Gilbert Dussier,Attack,26,AS Nancy,Championnat National,36,15,0,15
1976,Jupp Heynckes,Centre-Forward,31,Bor. M'gladbach,Bundesliga,20,15,0,15
1976,Willi Reimann,Centre-Forward,26,Hamburger SV,2. Bundesliga,34,15,0,15
1976,François M'Pelé,Centre-Forward,28,Paris SG,Ligue 1,34,15,0,15
1976,Karl-Heinz Granitza,Centre-Forward,24,Hertha BSC,2. Bundesliga,27,15,0,15
1976,Jacques Zimako,Left Winger,24,SEC Bastia,Ligue 2,37,14,0,14
1976,Manfred Burgsmüller,Attacking Midfield,26,Bor. Dortmund,Bundesliga,24,14,0,14
1976,Robert Pintenat,Centre-Forward,28,FC Sochaux,Championnat National,33,14,0,14
1976,Claude Papi,Attacking Midfield,27,SEC Bastia,Ligue 2,37,14,0,14
1976,Daniel Jeandupeux,Centre-Forward,27,G. Bordeaux,Ligue 2,30,14,0,14
1976,Olivier Rouyer,Right Winger,20,AS Nancy,Championnat National,37,14,0,14
1976,Harry Ellbracht,Centre-Forward,22,Saarbrücken,3. Liga,30,13,1,14
1976,Ronald Worm,Centre-Forward,22,MSV Duisburg,3. Liga,34,13,1,14
1976,Arno Steffenhagen,Left Winger,26,Hamburger SV,2. Bundesliga,32,13,1,14
1976,Allan Simonsen,Second Striker,23,Bor. M'gladbach,Bundesliga,34,12,2,14
1976,Rüdiger Abramczik,Right Winger,20,FC Schalke 04,2. Bundesliga,31,10,4,14
1977,Carlos Bianchi,Centre-Forward,28,Paris SG,Ligue 1,38,37,0,37
1977,Gerd Müller,Centre-Forward,31,Bayern Munich,Bundesliga,33,24,7,31
1977,Delio Onnis,Centre-Forward,29,Monaco,Ligue 1,35,29,0,29
1977,Nenad Bjekovic,Second Striker,29,OGC Nice,Ligue 1,35,29,0,29
1977,Mario Kempes,Centre-Forward,22,Valencia,LaLiga,34,28,0,28
1977,Paolo Rossi,Centre-Forward,20,Vicenza,Serie C - A,30,24,0,24
1977,Bernard Lacombe,Centre-Forward,24,Olympique Lyon,Ligue 1,33,24,0,24
1977,Santillana,Centre-Forward,24,Real Madrid,LaLiga,34,24,0,24
1977,Dieter Müller,Centre-Forward,23,1.FC Köln,Bundesliga,33,24,0,24
1977,Klaus Toppmöller,Centre-Forward,25,1.FC K'lautern,2. Bundesliga,34,21,1,22
1977,Jupp Heynckes,Centre-Forward,32,Bor. M'gladbach,Bundesliga,21,18,4,22
1977,Boubacar Sarr,Centre-Forward,25,Marseille,Ligue 1,38,21,0,21
1977,Albert Gemmrich,Left Winger,22,R. Strasbourg,Ligue 1,38,21,0,21
1977,Manfred Burgsmüller,Attacking Midfield,27,Bor. Dortmund,Bundesliga,34,20,0,20
1977,Klaus Fischer,Centre-Forward,27,FC Schalke 04,2. Bundesliga,32,20,0,20
1977,Marc Berdoll,Centre-Forward,24,Marseille,Ligue 1,37,20,0,20
1977,Heinz Flohe,Attacking Midfield,29,1.FC Köln,Bundesliga,34,14,5,19
1977,Christian Dalger,Right Winger,27,Monaco,Ligue 1,36,18,0,18
1977,Jesús Satrustegui,Centre-Forward,23,Real Sociedad,LaLiga,32,18,0,18
1977,Johnny Rep,Right Winger,25,SEC Bastia,Ligue 2,30,18,0,18
1977,Michel Platini,Attacking Midfield,22,AS Nancy,Championnat National,36,18,0,18
1977,Allan Simonsen,Second Striker,24,Bor. M'gladbach,Bundesliga,31,17,1,18
1977,Karl-Heinz Granitza,Centre-Forward,25,Hertha BSC,2. Bundesliga,31,17,0,17
1977,Franz Gerber,Centre-Forward,23,FC St. Pauli,2. Bundesliga,32,16,1,17
1977,Uli Hoeneß,Right Winger,25,Bayern Munich,Bundesliga,30,11,6,17
1978,Hans Krankl,Centre-Forward,25,Barcelona,LaLiga,30,29,0,29
1978,Carlos Bianchi,Centre-Forward,29,Paris SG,Ligue 1,36,27,0,27
1978,Klaus Allofs,Centre-Forward,21,F. Düsseldorf,2. Bundesliga,33,22,2,24
1978,Karl-Heinz Rummenigge,Centre-Forward,22,Bayern Munich,Bundesliga,34,14,10,24
1978,Quini,Centre-Forward,28,Sporting Gijón,LaLiga2,33,23,0,23
1978,Delio Onnis,Centre-Forward,30,Monaco,Ligue 1,34,22,0,22
1978,Éric Pécout,Centre-Forward,22,FC Nantes,Ligue 1,30,22,0,22
1978,Klaus Fischer,Centre-Forward,28,FC Schalke 04,2. Bundesliga,34,21,1,22
1978,Gilbert Marguerite,Attack,24,Nîmes Olympique,Championnat National,36,21,0,21
1978,Dominique Rocheteau,Centre-Forward,23,Saint-Étienne,Ligue 2,37,21,0,21
1978,Pierre Pleimelding,Centre-Forward,25,LOSC Lille,Ligue 1,38,21,0,21
1978,Jesús Satrustegui,Centre-Forward,24,Real Sociedad,LaLiga,30,20,0,20
1978,Bruno Giordano,Centre-Forward,21,Lazio,Serie A,29,19,0,19
1978,Kevin Keegan,Centre-Forward,27,Hamburger SV,2. Bundesliga,34,17,2,19
1978,Rüdiger Abramczik,Right Winger,22,FC Schalke 04,2. Bundesliga,34,18,0,18
1978,Santillana,Centre-Forward,25,Real Madrid,LaLiga,33,18,0,18
1978,Albert Gemmrich,Left Winger,23,R. Strasbourg,Ligue 1,38,17,1,18
1978,Klaus Toppmöller,Centre-Forward,26,1.FC K'lautern,2. Bundesliga,30,17,0,17
1978,Nenad Bjekovic,Second Striker,30,OGC Nice,Ligue 1,28,17,0,17
1978,Dieter Hoeneß,Centre-Forward,25,VfB Stuttgart,Bundesliga,32,16,1,17
1978,Zvonko Ivezić,Attack,29,FC Sochaux,Championnat National,26,15,2,17
1978,Paul Breitner,Left-Back,26,Bayern Munich,Bundesliga,33,12,5,17
1978,Roberto Cabral,Attack,26,LOSC Lille,Ligue 1,38,16,0,16
1978,Zarko Olarevic,Attack,27,LOSC Lille,Ligue 1,38,15,1,16
1978,Hansi Müller,Central Midfield,20,VfB Stuttgart,Bundesliga,30,13,3,16
1979,Karl-Heinz Rummenigge,Centre-Forward,23,Bayern Munich,Bundesliga,34,26,0,26
1979,Quini,Centre-Forward,29,Sporting Gijón,LaLiga2,34,24,0,24
1979,Santillana,Centre-Forward,26,Real Madrid,LaLiga,33,23,0,23
1979,Mario Kempes,Centre-Forward,24,Valencia,LaLiga,32,22,0,22
1979,Erwin Kostedde,Centre-Forward,33,Stade Lavallois,Ligue 2,34,21,0,21
1979,Delio Onnis,Centre-Forward,31,Monaco,Ligue 1,30,21,0,21
1979,Dieter Müller,Centre-Forward,25,1.FC Köln,Bundesliga,34,21,0,21
1979,Horst Hrubesch,Centre-Forward,28,Hamburger SV,2. Bundesliga,34,21,0,21
1979,Manfred Burgsmüller,Attacking Midfield,29,Bor. Dortmund,Bundesliga,34,20,0,20
1979,Harald Nickel,Centre-Forward,25,Bor. M'gladbach,Bundesliga,33,20,0,20
1979,Pierre Pleimelding,Centre-Forward,26,LOSC Lille,Ligue 1,38,18,1,19
1979,Drago Vabec,Left Winger,28,St. Brest,Ligue 1,38,17,1,18
1979,Roberto Bettega,Centre-Forward,28,Juventus,Serie A,28,16,2,18
1979,Reiner Geye,Right Winger,29,1.FC K'lautern,2. Bundesliga,33,17,0,17
1979,Jesús Satrustegui,Centre-Forward,25,Real Sociedad,LaLiga,32,17,0,17
1979,Michel Platini,Attacking Midfield,24,Saint-Étienne,Ligue 2,33,16,0,16
1979,Dieter Hoeneß,Centre-Forward,26,Bayern Munich,Bundesliga,32,16,0,16
1979,Klaus Allofs,Centre-Forward,22,F. Düsseldorf,2. Bundesliga,28,16,0,16
1979,Alessandro Altobelli,Centre-Forward,23,Inter,Serie A,29,15,1,16
1979,Johnny Rep,Right Winger,27,Saint-Étienne,Ligue 2,31,15,0,15
1979,Bernard Genghini,Attacking Midfield,21,FC Sochaux,Championnat National,38,15,0,15
1979,Nenad Bjekovic,Second Striker,31,OGC Nice,Ligue 1,35,15,0,15
1979,Friedhelm Funkel,Attacking Midfield,25,Bay. Uerdingen,Oberliga Niederrhein,34,14,1,15
1979,Yves Ehrlacher,Attacking Midfield,24,Lens,Ligue 1,37,14,0,14
1979,Yannick Stopyra,Centre-Forward,18,FC Sochaux,Championnat National,34,14,0,14
1979,Hansi Müller,Central Midfield,21,VfB Stuttgart,Bundesliga,32,14,0,14
1979,Paolo Rossi,Centre-Forward,22,Perugia,Serie C - B,28,13,1,14
1979,Victor Trossero,Centre-Forward,25,FC Nantes,Ligue 1,32,13,1,14
1979,Roberto Pruzzo,Centre-Forward,24,AS Roma,Serie A,28,12,2,14
1979,Francis Piasecki,Attacking Midfield,27,R. Strasbourg,Ligue 1,37,8,6,14
1979,Éric Pécout,Centre-Forward,23,FC Nantes,Ligue 1,34,13,0,13
1979,Jean-François Beltramini,Centre-Forward,31,Paris SG,Ligue 1,29,13,0,13
1979,Hans-Joachim Abel,Centre-Forward,27,VfL Bochum,Bundesliga,34,13,0,13
1979,Jacques Zimako,Left Winger,27,Saint-Étienne,Ligue 2,37,12,1,13
1979,Boubacar Sarr,Centre-Forward,27,Paris SG,Ligue 1,22,12,1,13
1979,Werner Dreßel,Centre-Forward,20,Werder Bremen,Bundesliga,33,12,1,13
1979,Georg Volkert,Left Winger,33,VfB Stuttgart,Bundesliga,27,12,0,12
1979,Benny Wendt,Centre-Forward,28,1.FC K'lautern,2. Bundesliga,29,12,0,12
1979,Francesco Graziani,Centre-Forward,26,Torino,Serie A,30,12,0,12
1979,Nambatingue Toko,Centre-Forward,26,US Valenciennes,Ligue 2,35,12,0,12
1979,Gilbert Marguerite,Attack,25,Nîmes Olympique,Championnat National,37,12,0,12
1979,Albert Gemmrich,Left Winger,24,G. Bordeaux,Ligue 2,38,12,0,12
1979,Alain Giresse,Attacking Midfield,26,G. Bordeaux,Ligue 2,37,12,0,12
1979,Bum-kun Cha,Centre-Forward,26,E. Frankfurt,Bundesliga,31,12,0,12
1979,Franco Selvaggi,Centre-Forward,26,Cagliari Calcio,Serie A,30,12,0,12
1979,Uwe Reinders,Centre-Forward,24,Werder Bremen,Bundesliga,34,11,1,12
1979,Bernd Hölzenbein,Attacking Midfield,33,E. Frankfurt,Bundesliga,29,11,0,11
1979,Hans-Günter Neues,Centre-Back,28,1.FC K'lautern,2. Bundesliga,32,11,0,11
1979,Walter Kelsch,Right Winger,23,VfB Stuttgart,Bundesliga,30,11,0,11
1979,Paco Rubio,Attacking Midfield,25,AS Nancy,Championnat National,37,11,0,11
1980,Karl-Heinz Rummenigge,Centre-Forward,24,Bayern Munich,Bundesliga,34,29,1,30
1980,Manfred Burgsmüller,Attacking Midfield,30,Bor. Dortmund,Bundesliga,33,27,1,28
1980,Delio Onnis,Centre-Forward,32,FC Tours,National 3 - Grp. C,38,24,0,24
1980,Uwe Krause,Centre-Forward,24,Stade Lavallois,Ligue 2,38,23,0,23
1980,Sima Nikolic,Attack,25,Olympique Lyon,Ligue 1,34,21,0,21
1980,Paul Breitner,Left-Back,28,Bayern Munich,Bundesliga,30,17,4,21
1980,Quini,Centre-Forward,30,Barcelona,LaLiga,30,20,0,20
1980,Michel Platini,Attacking Midfield,25,Saint-Étienne,Ligue 2,35,20,0,20
1980,Klaus Allofs,Centre-Forward,23,F. Düsseldorf,2. Bundesliga,33,19,0,19
1980,Juanito,Right Winger,25,Real Madrid,LaLiga,33,19,0,19
1980,Victor Trossero,Centre-Forward,26,Monaco,Ligue 1,37,18,0,18
1980,Roberto Pruzzo,Centre-Forward,25,AS Roma,Serie A,28,18,0,18
1980,Bernard Lacombe,Centre-Forward,27,G. Bordeaux,Ligue 2,34,18,0,18
1980,Horst Hrubesch,Centre-Forward,29,Hamburger SV,2. Bundesliga,29,17,1,18
1980,Dieter Müller,Centre-Forward,26,1.FC Köln,Bundesliga,34,17,0,17
1980,Kurt Pinkall,Centre-Forward,25,VfL Bochum,Bundesliga,32,17,0,17
1980,Arne Ökland,Centre-Forward,26,B. Leverkusen,Bundesliga,34,16,0,16
1980,Andrzej Szarmach,Centre-Forward,29,AJ Auxerre,Ligue 2,20,16,0,16
1980,Fernando Morena,Centre-Forward,28,Valencia,LaLiga,31,16,0,16
1980,Gerd-Volker Schock,Centre-Forward,30,Arm. Bielefeld,3. Liga,32,16,0,16
1980,Jesús Satrustegui,Centre-Forward,26,Real Sociedad,LaLiga,28,16,0,16
1980,Wilfried Hannes,Centre-Back,23,Bor. M'gladbach,Bundesliga,33,16,0,16
1980,Dominique Rocheteau,Centre-Forward,25,Paris SG,Ligue 1,37,16,0,16
1980,Francis Piasecki,Attacking Midfield,28,R. Strasbourg,Ligue 1,38,11,5,16
1980,Enzo Ferrero,Centre-Forward,27,Sporting Gijón,LaLiga2,30,15,0,15
1980,Olivier Rouyer,Right Winger,24,AS Nancy,Championnat National,37,15,0,15
1980,Bernard Zénier,Centre-Forward,22,AS Nancy,Championnat National,38,15,0,15
1980,Vicky Peretz,Centre-Forward,27,R. Strasbourg,Ligue 1,37,14,1,15
1980,Albert Gemmrich,Left Winger,25,G. Bordeaux,Ligue 2,33,14,0,14
1980,Viorel Nastase,Centre-Forward,26,1860 Munich,3. Liga,23,14,0,14
1980,Johnny Rep,Right Winger,28,Saint-Étienne,Ligue 2,32,14,0,14
1980,Stephan Groß,Right-Back,26,Karlsruher SC,2. Bundesliga,34,14,0,14
1980,Bernard Genghini,Attacking Midfield,22,FC Sochaux,Championnat National,36,13,1,14
1980,Friedhelm Funkel,Attacking Midfield,26,1.FC K'lautern,2. Bundesliga,31,13,0,13
1980,Abel,Centre-Forward,27,Sporting Gijón,LaLiga2,33,13,0,13
1980,Santillana,Centre-Forward,27,Real Madrid,LaLiga,31,13,0,13
1980,Massimo Palanca,Centre-Forward,26,Catanzaro,Serie B,28,13,0,13
1980,Pierre Pleimelding,Centre-Forward,27,LOSC Lille,Ligue 1,32,13,0,13
1980,Ilyas Tüfekci,Attacking Midfield,20,VfB Stuttgart,Bundesliga,24,13,0,13
1980,Louis Marcialis,Attacking Midfield,19,SEC Bastia,Ligue 2,32,12,1,13
1980,Laurent Roussey,Centre-Forward,18,Saint-Étienne,Ligue 2,36,12,0,12
1980,Abdelkarim Krimau,Centre-Forward,25,LOSC Lille,Ligue 1,35,12,0,12
1980,Harald Nickel,Centre-Forward,26,Bor. M'gladbach,Bundesliga,32,12,0,12
1980,Philippe Piette,Midfield,21,FC Metz,Ligue 1,32,12,0,12
1980,Alessandro Altobelli,Centre-Forward,24,Inter,Serie A,29,12,0,12
1980,Francisco García Hernández,Central Midfield,25,Real Madrid,LaLiga,24,12,0,12
1980,Reiner Geye,Right Winger,30,1.FC K'lautern,2. Bundesliga,34,11,1,12
1980,Pascal Raspollini,Left Winger,25,FC Metz,Ligue 1,26,10,2,12
1980,Raul Nogues,Attacking Midfield,28,OGC Nice,Ligue 1,38,10,2,12
1980,Rüdiger Abramczik,Right Winger,24,Bor. Dortmund,Bundesliga,33,9,3,12
1981,Delio Onnis,Centre-Forward,33,FC Tours,National 3 - Grp. C,38,29,0,29
1981,Karl-Heinz Rummenigge,Centre-Forward,25,Bayern Munich,Bundesliga,32,14,14,28
1981,Quini,Centre-Forward,31,Barcelona,LaLiga,32,27,0,27
1981,Horst Hrubesch,Centre-Forward,30,Hamburger SV,2. Bundesliga,32,27,0,27
1981,Paul Breitner,Left-Back,29,Bayern Munich,Bundesliga,29,18,7,25
1981,Andrzej Szarmach,Centre-Forward,30,AJ Auxerre,Ligue 2,33,24,0,24
1981,Manfred Burgsmüller,Attacking Midfield,31,Bor. Dortmund,Bundesliga,34,22,0,22
1981,Michel Platini,Attacking Midfield,26,Saint-Étienne,Ligue 2,36,22,0,22
1981,Dieter Hoeneß,Centre-Forward,28,Bayern Munich,Bundesliga,33,21,1,22
1981,Teitur Thórdarson,Attack,29,Lens,Ligue 1,38,19,0,19
1981,Uwe Krause,Centre-Forward,25,Stade Lavallois,Ligue 2,35,18,0,18
1981,Drago Vabec,Left Winger,30,St. Brest,Ligue 1,26,18,0,18
1981,Uwe Reinders,Centre-Forward,26,Werder Bremen,Bundesliga,34,18,0,18
1981,Ronald Worm,Centre-Forward,27,E. Braunschweig,2. Bundesliga,33,17,1,18
1981,Bernard Lacombe,Centre-Forward,28,G. Bordeaux,Ligue 2,33,17,0,17
1981,Peter Cestonaro,Centre-Forward,27,Darmstadt 98,Bundesliga,33,16,0,16
1981,Roberto Pruzzo,Centre-Forward,26,AS Roma,Serie A,26,15,0,15
1981,Tony Woodcock,Left Winger,25,1.FC Köln,Bundesliga,32,15,0,15
1981,Norbert Meier,Attacking Midfield,22,Werder Bremen,Bundesliga,33,15,0,15
1981,Yannick Stopyra,Centre-Forward,20,FC Sochaux,Championnat National,38,15,0,15
1981,Pierre Littbarski,Attacking Midfield,21,1.FC Köln,Bundesliga,33,15,0,15
1981,Ralf Edström,Centre-Forward,28,Monaco,Ligue 1,35,15,0,15
1981,Kurt Pinkall,Centre-Forward,26,Bor. M'gladbach,Bundesliga,30,15,0,15
1981,Werner Heck,Centre-Forward,26,1.FC Nuremberg,2. Bundesliga,33,14,1,15
1981,Jimmy Hartwig,Defensive Midfield,26,Hamburger SV,2. Bundesliga,31,14,0,14
1981,Dieter Müller,Centre-Forward,27,VfB Stuttgart,Bundesliga,30,14,0,14
1981,Frank Mill,Centre-Forward,22,Bor. M'gladbach,Bundesliga,32,14,0,14
1981,Arne Ökland,Centre-Forward,27,B. Leverkusen,Bundesliga,33,14,0,14
1981,Alain Giresse,Attacking Midfield,28,G. Bordeaux,Ligue 2,34,14,0,14
1981,Pello Uralde,Right Winger,23,Real Sociedad,LaLiga,28,14,0,14
1981,Vicky Peretz,Centre-Forward,28,R. Strasbourg,Ligue 1,34,13,1,14
1981,Lars Bastrup,Centre-Forward,25,Hamburger SV,2. Bundesliga,34,13,1,14
1981,Thomas Allofs,Centre-Forward,21,F. Düsseldorf,2. Bundesliga,33,13,1,14
1981,Bum-kun Cha,Centre-Forward,28,E. Frankfurt,Bundesliga,31,11,3,14
1981,Wolfgang Patzke,Left Midfield,22,VfL Bochum,Bundesliga,28,13,0,13
1981,Santi Llorente,Right Winger,25,Sevilla FC,LaLiga,31,13,0,13
1981,Bodo Mattern,Centre-Forward,23,Darmstadt 98,Bundesliga,24,13,0,13
1981,Engin Verel,Attacking Midfield,24,LOSC Lille,Ligue 1,31,13,0,13
1981,José Touré,Attacking Midfield,20,FC Nantes,Ligue 1,28,13,0,13
1981,Jean-François Larios,Attacking Midfield,24,Saint-Étienne,Ligue 2,37,13,0,13
1981,Hans-Peter Briegel,Centre-Back,25,1.FC K'lautern,2. Bundesliga,32,13,0,13
1981,Manu Sarabia,Centre-Forward,24,Athletic,LaLiga,31,13,0,13
1981,Sima Nikolic,Attack,26,Olympique Lyon,Ligue 1,35,13,0,13
1981,Frank Arnesen,Attacking Midfield,24,Valencia,LaLiga,32,13,0,13
1981,Jesús Satrustegui,Centre-Forward,27,Real Sociedad,LaLiga,33,13,0,13
1981,Bernard Zénier,Centre-Forward,23,AS Nancy,Championnat National,33,13,0,13
1981,Gerhard Bold,Sweeper,26,Karlsruher SC,2. Bundesliga,34,13,0,13
1981,Bruno Bellone,Left Winger,19,Monaco,Ligue 1,30,12,0,12
1981,Bernard Genghini,Attacking Midfield,23,FC Sochaux,Championnat National,37,12,0,12
1981,Didier Six,Left Winger,26,VfB Stuttgart,Bundesliga,30,12,0,12
1982,Karl-Heinz Rummenigge,Centre-Forward,26,Bayern Munich,Bundesliga,34,20,9,29
1982,Dani,Right Winger,31,Athletic,LaLiga,32,18,10,28
1982,Vahid Halilhodzic,Centre-Forward,29,FC Nantes,Ligue 1,36,27,0,27
1982,Manu Sarabia,Centre-Forward,25,Athletic,LaLiga,33,16,10,26
1982,Andrzej Szarmach,Centre-Forward,31,AJ Auxerre,Ligue 2,34,24,0,24
1982,Michel Platini,Attacking Midfield,27,Juventus,Serie A,29,16,8,24
1982,Rudi Völler,Centre-Forward,22,Werder Bremen,Bundesliga,31,23,0,23
1982,Abdelkarim Krimau,Centre-Forward,27,FC Metz,Ligue 1,36,23,0,23
1982,Atli Edvaldsson,Centre-Forward,25,F. Düsseldorf,2. Bundesliga,34,21,0,21
1982,Karl Allgöwer,Central Midfield,25,VfB Stuttgart,Bundesliga,33,21,0,21
1982,Diego Maradona,Attacking Midfield,21,Barcelona,LaLiga,20,11,10,21
1982,Bernard Lacombe,Centre-Forward,29,G. Bordeaux,Ligue 2,33,20,0,20
1982,Jean-François Beltramini,Centre-Forward,34,Rouen,Championnat National,37,19,0,19
1982,Horst Hrubesch,Centre-Forward,31,Hamburger SV,2. Bundesliga,30,18,1,19
1982,Dieter Hoeneß,Centre-Forward,29,Bayern Munich,Bundesliga,34,17,2,19
1982,Manfred Burgsmüller,Attacking Midfield,32,Bor. Dortmund,Bundesliga,32,17,1,18
1982,Dieter Müller,Centre-Forward,28,G. Bordeaux,Ligue 2,29,17,0,17
1982,Toni Kurbos,Centre-Forward,21,FC Metz,Ligue 1,35,17,0,17
1982,Pierre Littbarski,Attacking Midfield,22,1.FC Köln,Bundesliga,34,16,1,17
1982,Yannick Stopyra,Centre-Forward,21,FC Sochaux,Championnat National,36,16,1,17
1982,Rüdiger Abramczik,Right Winger,26,Bor. Dortmund,Bundesliga,27,16,0,16
1982,Paul Breitner,Left-Back,30,Bayern Munich,Bundesliga,22,9,7,16
1982,Alessandro Altobelli,Centre-Forward,26,Inter,Serie A,29,15,0,15
1982,Domenico Penzo,Centre-Forward,28,Hellas Verona,Serie A,29,15,0,15
1982,Hugo Sánchez,Centre-Forward,23,Atlético Madrid,LaLiga,31,15,0,15
1983,Domenico Penzo,Centre-Forward,28,Hellas Verona,Serie A,29,15,0,15
1983,Jürgen Milewski,Centre-Forward,24,Hamburger SV,2. Bundesliga,31,14,1,15
1983,Uwe Krause,Centre-Forward,26,Stade Lavallois,Ligue 2,30,14,0,14
1983,Jean-Marc Ferreri,Attacking Midfield,19,AJ Auxerre,Ligue 2,32,14,0,14
1983,Peter Reichert,Centre-Forward,20,VfB Stuttgart,Bundesliga,34,14,0,14
1983,Roger Milla,Centre-Forward,30,SEC Bastia,Ligue 2,29,14,0,14
1983,Thierry Meyer,Attack,24,AS Nancy,Championnat National,30,14,0,14
1983,Mario Kempes,Centre-Forward,27,Valencia,LaLiga,27,13,1,14
1983,Arne Ökland,Centre-Forward,28,B. Leverkusen,Bundesliga,34,13,1,14
1983,José Touré,Attacking Midfield,21,FC Nantes,Ligue 1,37,13,0,13
1983,Daniel Xuereb,Centre-Forward,22,Lens,Ligue 1,38,13,0,13
1983,Salah Assad,Centre-Forward,23,Mulhouse,France,26,13,0,13
1983,Rubén Umpiérrez,Attacking Midfield,25,AS Nancy,Championnat National,37,13,0,13
1983,Kees Kist,Centre-Forward,29,Paris SG,Ligue 1,34,12,1,13
1983,Klaus Allofs,Centre-Forward,25,1.FC Köln,Bundesliga,24,12,1,13
1983,Juanito,Right Winger,27,Real Madrid,LaLiga,28,9,4,13
1983,Estanis Argote,Left Winger,25,Athletic,LaLiga,33,6,7,13
1983,Roberto Pruzzo,Centre-Forward,27,AS Roma,Serie A,27,12,0,12
1983,Alain Giresse,Attacking Midfield,29,G. Bordeaux,Ligue 2,35,12,0,12
1983,Klaus Fischer,Centre-Forward,32,1.FC Köln,Bundesliga,32,12,0,12
1983,Albert Emon,Left Winger,29,Olympique Lyon,Ligue 1,30,12,0,12
1983,Poli Rincón,Centre-Forward,25,Real Betis,LaLiga,14,11,1,12
1983,Drago Vabec,Left Winger,31,Brest Armorique,Ligue 1,27,11,1,12
1983,Paolo Rossi,Centre-Forward,25,Juventus,Serie A,22,7,5,12
1983,Dominique Rocheteau,Centre-Forward,27,Paris SG,Ligue 1,26,11,0,11
1983,Karl-Heinz Rummenigge,Centre-Forward,27,Bayern Munich,Bundesliga,29,26,13,39
1983,Michel Platini,Attacking Midfield,28,Juventus,Serie A,28,20,3,23
1983,Klaus Allofs,Centre-Forward,26,1.FC Köln,Bundesliga,34,20,2,22
1983,Delio Onnis,Centre-Forward,35,SC Toulon Var,National 2 - Grp. A,36,21,0,21
1983,Patrice Garande,Centre-Forward,22,AJ Auxerre,Ligue 2,37,21,0,21
1983,Zico,Attacking Midfield,30,Udinese,Serie A,24,19,2,21
1983,Andrzej Szarmach,Centre-Forward,32,AJ Auxerre,Ligue 2,35,20,0,20
1983,Philippe Anziani,Second Striker,21,FC Sochaux,Championnat National,33,19,0,19
1983,Frank Mill,Centre-Forward,24,Bor. M'gladbach,Bundesliga,32,19,0,19
1983,Christian Schreier,Attacking Midfield,24,VfL Bochum,Bundesliga,33,18,1,19
1983,Bernard Lacombe,Centre-Forward,30,G. Bordeaux,Ligue 2,35,18,0,18
1983,Rudi Völler,Centre-Forward,23,Werder Bremen,Bundesliga,31,18,0,18
1983,Bernard Genghini,Attacking Midfield,25,Monaco,Ligue 1,38,18,0,18
1983,Juanito,Right Winger,28,Real Madrid,LaLiga,31,17,1,18
1983,Michael Rummenigge,Attacking Midfield,19,Bayern Munich,Bundesliga,33,11,7,18
1983,François Brisson,Left Winger,25,Lens,Ligue 1,38,17,0,17
1983,Jorge da Silva,Centre-Forward,21,Valladolid,LaLiga2,30,17,0,17
1983,Pierre Littbarski,Attacking Midfield,23,1.FC Köln,Bundesliga,33,17,0,17
1983,Paolo Rossi,Centre-Forward,26,Juventus,Serie A,30,13,4,17
1983,Alain Giresse,Attacking Midfield,30,G. Bordeaux,Ligue 2,34,16,0,16
1983,Fritz Walter,Centre-Forward,22,Waldh. Mannheim,3. Liga,34,16,0,16
1983,Friedhelm Funkel,Attacking Midfield,29,Bay. Uerdingen,Oberliga Niederrhein,33,15,0,15
1983,Thomas Allofs,Centre-Forward,23,1.FC K'lautern,2. Bundesliga,34,15,0,15
1983,Dieter Schatzschneider,Centre-Forward,25,Hamburger SV,2. Bundesliga,31,15,0,15
1983,Toni Kurbos,Centre-Forward,22,FC Metz,Ligue 1,29,15,0,15
1983,Herbert Waas,Centre-Forward,19,B. Leverkusen,Bundesliga,25,15,0,15
1983,Uwe Bein,Attacking Midfield,22,K. Offenbach,Regionalliga Südwest,34,14,1,15
1983,Uwe Rahn,Attacking Midfield,21,Bor. M'gladbach,Bundesliga,31,14,1,15
1983,Norbert Meier,Attacking Midfield,24,Werder Bremen,Bundesliga,33,14,1,15
1983,Maurizio Iorio,Attack,24,Hellas Verona,Serie A,25,14,0,14
1983,Jean-François Beltramini,Centre-Forward,35,Rouen,Championnat National,38,14,0,14
1983,Dieter Müller,Centre-Forward,29,G. Bordeaux,Ligue 2,28,14,0,14
1983,Diego Maradona,Attacking Midfield,22,Barcelona,LaLiga,16,11,3,14
1983,Frank Neubarth,Centre-Forward,20,Werder Bremen,Bundesliga,31,13,0,13
1983,Torbjörn Nilsson,Centre-Forward,28,1.FC K'lautern,2. Bundesliga,32,13,0,13
1983,Peter Reichert,Centre-Forward,21,VfB Stuttgart,Bundesliga,31,13,0,13
1983,Vahid Halilhodzic,Centre-Forward,30,FC Nantes,Ligue 1,29,13,0,13
1983,Santillana,Centre-Forward,30,Real Madrid,LaLiga,31,13,0,13
1983,Rudi Bommer,Defensive Midfield,25,F. Düsseldorf,2. Bundesliga,34,11,2,13
1983,Luther Blissett,Centre-Forward,25,Milan,Serie A,30,5,8,13
1983,Marcos Alonso,Attacking Midfield,23,Barcelona,LaLiga,34,12,0,12
1983,Manfred Burgsmüller,Attacking Midfield,33,1.FC Nuremberg,2. Bundesliga,34,12,0,12
1983,Hugo Sánchez,Centre-Forward,24,Atlético Madrid,LaLiga,27,12,0,12
1983,Peter Loontiens,Centre-Forward,24,Bay. Uerdingen,Oberliga Niederrhein,30,12,0,12
1983,Ásgeir Sigurvinsson,Left Midfield,28,VfB Stuttgart,Bundesliga,31,12,0,12
1983,Roberto López Ufarte,Left Winger,25,Real Sociedad,LaLiga,32,12,0,12
1983,Paolo Monelli,Centre-Forward,20,Fiorentina,Serie A,29,12,0,12
1983,Günter Thiele,Centre-Forward,21,F. Düsseldorf,2. Bundesliga,25,12,0,12
1983,Karl Allgöwer,Central Midfield,26,VfB Stuttgart,Bundesliga,29,12,0,12
1983,Massimo Briaschi,Second Striker,25,Genoa,Serie A,29,12,0,12
1984,Vahid Halilhodzic,Centre-Forward,31,FC Nantes,Ligue 1,34,28,0,28
1984,Klaus Allofs,Centre-Forward,27,1.FC Köln,Bundesliga,32,26,0,26
1984,Rudi Völler,Centre-Forward,24,Werder Bremen,Bundesliga,32,25,0,25
1984,Diego Maradona,Attacking Midfield,23,Napoli,Serie A,30,14,9,23
1984,Bernard Lacombe,Centre-Forward,31,G. Bordeaux,Ligue 2,36,22,0,22
1984,Thomas Allofs,Centre-Forward,24,1.FC K'lautern,2. Bundesliga,31,19,0,19
1984,Gérard Buscher,Centre-Forward,24,Brest Armorique,Ligue 1,35,19,0,19
1984,Hugo Sánchez,Centre-Forward,25,Atlético Madrid,LaLiga,33,19,0,19
1984,Karl Allgöwer,Central Midfield,27,VfB Stuttgart,Bundesliga,32,19,0,19
1984,Michel Platini,Attacking Midfield,29,Juventus,Serie A,30,18,1,19
1984,Jorge Valdano,Centre-Forward,28,Real Madrid,LaLiga,26,17,2,19
1984,Klaus Täuber,Centre-Forward,26,FC Schalke 04,2. Bundesliga,30,18,0,18
1984,Siegfried Reich,Centre-Forward,24,Arm. Bielefeld,3. Liga,33,18,0,18
1984,Lothar Matthäus,Defensive Midfield,23,Bayern Munich,Bundesliga,33,16,2,18
1984,Klaus Fischer,Centre-Forward,34,VfL Bochum,Bundesliga,34,16,2,18
1984,Alessandro Altobelli,Centre-Forward,28,Inter,Serie A,30,17,0,17
1984,Günter Thiele,Centre-Forward,22,F. Düsseldorf,2. Bundesliga,33,17,0,17
1984,Delio Onnis,Centre-Forward,36,SC Toulon Var,National 2 - Grp. A,30,17,0,17
1984,Yannick Stopyra,Centre-Forward,23,Toulouse,Ligue 1,38,17,0,17
1984,Pierre Littbarski,Attacking Midfield,24,1.FC Köln,Bundesliga,28,16,1,17
1984,Stéphane Paille,Centre-Forward,19,FC Sochaux,Championnat National,38,15,2,17
1984,Frank Mill,Centre-Forward,25,Bor. M'gladbach,Bundesliga,31,16,0,16
1984,Roland Wohlfarth,Centre-Forward,21,Bayern Munich,Bundesliga,32,12,4,16
1984,Dominique Rocheteau,Centre-Forward,29,Paris SG,Ligue 1,31,15,0,15
1984,Steve Archibald,Centre-Forward,27,Barcelona,LaLiga,32,15,0,15
1984,Thomas von Heesen,Attacking Midfield,22,Hamburger SV,2. Bundesliga,32,15,0,15
1984,Jürgen Klinsmann,Centre-Forward,19,VfB Stuttgart,Bundesliga,32,15,0,15
1984,Frank Neubarth,Centre-Forward,21,Werder Bremen,Bundesliga,31,14,0,14
1984,Philippe Anziani,Second Striker,22,Monaco,Ligue 1,34,14,0,14
1984,Negro Cabrera,Centre-Forward,27,Atlético Madrid,LaLiga,24,14,0,14
1984,Bernard Genghini,Attacking Midfield,26,Monaco,Ligue 1,34,14,0,14
1984,Uwe Rahn,Attacking Midfield,22,Bor. M'gladbach,Bundesliga,34,14,0,14
1984,Michel Pineda,Centre-Forward,20,Español,LaLiga2,32,14,0,14
1984,Omar da Fonseca,Centre-Forward,24,FC Tours,National 3 - Grp. C,36,14,0,14
1984,Patrice Garande,Centre-Forward,23,AJ Auxerre,Ligue 2,37,13,0,13
1984,Bruno Bellone,Left Winger,22,Monaco,Ligue 1,34,13,0,13
1984,Dusan Savic,Centre-Forward,29,LOSC Lille,Ligue 1,35,13,0,13
1984,Thierry Meyer,Attack,26,SEC Bastia,Ligue 2,36,13,0,13
1984,Rubén Umpiérrez,Attacking Midfield,27,AS Nancy,Championnat National,38,13,0,13
1984,Philippe Vercruysse,Attacking Midfield,22,Lens,Ligue 1,36,12,1,13
1984,Dieter Müller,Centre-Forward,30,G. Bordeaux,Ligue 2,36,12,1,13
1984,Daniel Bertoni,Right Winger,29,Napoli,Serie A,27,11,2,13
1984,Pietro Paolo Virdis,Centre-Forward,27,Milan,Serie A,28,9,4,13
1984,Wolfgang Schäfer,Centre-Forward,25,Bay. Uerdingen,Oberliga Niederrhein,30,12,0,12
1984,Éric Pécout,Centre-Forward,28,R. Strasbourg,Ligue 1,37,12,0,12
1984,Uwe Reinders,Centre-Forward,29,Werder Bremen,Bundesliga,28,12,0,12
1984,Emanuel Günther,Centre-Forward,29,Karlsruher SC,2. Bundesliga,32,12,0,12
1984,Hans-Jörg Criens,Centre-Forward,23,Bor. M'gladbach,Bundesliga,31,12,0,12
1984,Massimo Briaschi,Second Striker,26,Juventus,Serie A,27,12,0,12
1984,Walter Kelsch,Right Winger,28,R. Strasbourg,Ligue 1,37,12,0,12
1985,Stefan Kuntz,Centre-Forward,22,VfL Bochum,Bundesliga,34,22,2,24
1985,Jules Bocandé,Centre-Forward,26,FC Metz,Ligue 1,32,23,0,23
1985,Hugo Sánchez,Centre-Forward,26,Real Madrid,LaLiga,33,22,1,23
1985,Karl Allgöwer,Central Midfield,28,VfB Stuttgart,Bundesliga,33,21,0,21
1985,Roland Wohlfarth,Centre-Forward,22,Bayern Munich,Bundesliga,25,13,8,21
1985,Frank Neubarth,Centre-Forward,22,Werder Bremen,Bundesliga,32,20,0,20
1985,Roberto Pruzzo,Centre-Forward,30,AS Roma,Serie A,24,19,1,20
1985,Victor Ramos,Attack,26,SC Toulon Var,National 2 - Grp. A,38,19,0,19
1985,Dominique Rocheteau,Centre-Forward,30,Paris SG,Ligue 1,35,19,0,19
1985,Dieter Hoeneß,Centre-Forward,32,Bayern Munich,Bundesliga,31,15,4,19
1985,Vahid Halilhodzic,Centre-Forward,32,FC Nantes,Ligue 1,36,18,0,18
1985,Klaus Täuber,Centre-Forward,27,FC Schalke 04,2. Bundesliga,33,16,2,18
1985,Abdelkarim Krimau,Centre-Forward,30,Le Havre AC,Ligue 1,34,17,0,17
1985,Bum-kun Cha,Centre-Forward,32,B. Leverkusen,Bundesliga,34,17,0,17
1985,Lothar Matthäus,Defensive Midfield,24,Bayern Munich,Bundesliga,23,10,7,17
1985,Jürgen Klinsmann,Centre-Forward,20,VfB Stuttgart,Bundesliga,33,16,0,16
1985,José Mari Bakero,Attacking Midfield,22,Real Sociedad,LaLiga,29,16,0,16
1985,Thomas Allofs,Centre-Forward,25,1.FC K'lautern,2. Bundesliga,31,16,0,16
1985,Jorge Valdano,Centre-Forward,29,Real Madrid,LaLiga,32,16,0,16
1985,Diego Maradona,Attacking Midfield,24,Napoli,Serie A,29,11,5,16
1985,Michael Rummenigge,Attacking Midfield,21,Bayern Munich,Bundesliga,31,10,6,16
1985,Uwe Reinders,Centre-Forward,30,G. Bordeaux,Ligue 2,35,15,0,15
1985,Jürgen Wegmann,Centre-Forward,21,Bor. Dortmund,Bundesliga,33,14,1,15
1985,Pietro Paolo Virdis,Centre-Forward,28,Milan,Serie A,28,6,9,15
1985,Herbert Waas,Centre-Forward,21,B. Leverkusen,Bundesliga,34,14,0,14
1985,Thomas Remark,Centre-Forward,25,Waldh. Mannheim,3. Liga,27,14,0,14
1985,Gérard Buscher,Centre-Forward,25,Brest Armorique,Ligue 1,34,14,0,14
1985,Pascal Mariini,Centre-Forward,24,Brest Armorique,Ligue 1,36,14,0,14
1985,Chérif Oudjani,Centre-Forward,20,Stade Lavallois,Ligue 2,31,14,0,14
1985,Manfred Burgsmüller,Attacking Midfield,35,Werder Bremen,Bundesliga,20,13,1,14
1985,Karl-Heinz Rummenigge,Centre-Forward,29,Inter,Serie A,24,13,1,14
1985,Bernard Bureau,Right Winger,26,LOSC Lille,Ligue 1,34,13,0,13
1985,Bernard Genghini,Attacking Midfield,27,Monaco,Ligue 1,34,13,0,13
1985,Frank Mill,Centre-Forward,26,Bor. M'gladbach,Bundesliga,30,13,0,13
1985,Pello Uralde,Right Winger,27,Real Sociedad,LaLiga,30,13,0,13
1985,Frank Hartmann,Attacking Midfield,24,FC Schalke 04,2. Bundesliga,34,13,0,13
1985,Dieter Eckstein,Centre-Forward,21,1.FC Nuremberg,2. Bundesliga,33,12,0,12
1985,Hans-Jörg Criens,Centre-Forward,24,Bor. M'gladbach,Bundesliga,32,12,0,12
1985,Christian Schreier,Attacking Midfield,26,B. Leverkusen,Bundesliga,33,12,0,12
1985,Michel Platini,Attacking Midfield,30,Juventus,Serie A,30,12,0,12
1985,Bruno Giordano,Centre-Forward,28,Napoli,Serie A,25,10,2,12
1985,Emilio Butragueño,Centre-Forward,22,Real Madrid,LaLiga,31,10,2,12
1985,Bernd Schuster,Attacking Midfield,25,Barcelona,LaLiga,22,10,2,12
1985,Sören Lerby,Central Midfield,27,Bayern Munich,Bundesliga,31,8,4,12
1985,Junior,Left-Back,31,Torino,Serie A,30,4,8,12
1985,Aldo Serena,Centre-Forward,25,Juventus,Serie A,25,11,0,11
1985,Gérard Soler,Centre-Forward,31,LOSC Lille,Ligue 1,36,11,0,11
1985,Heinz Gründel,Centre-Forward,28,Hamburger SV,2. Bundesliga,30,11,0,11
1985,Daniel Passarella,Sweeper,32,Fiorentina,Serie A,29,11,0,11
1985,Yannick Stopyra,Centre-Forward,24,Toulouse,Ligue 1,37,11,0,11
1986,Hugo Sánchez,Centre-Forward,27,Real Madrid,LaLiga,41,34,1,35
1986,Uwe Rahn,Attacking Midfield,24,Bor. M'gladbach,Bundesliga,31,24,0,24
1986,Fritz Walter,Centre-Forward,25,Waldh. Mannheim,3. Liga,33,23,0,23
1986,Rudi Völler,Centre-Forward,26,Werder Bremen,Bundesliga,30,22,0,22
1986,Norbert Dickel,Centre-Forward,24,Bor. Dortmund,Bundesliga,32,20,0,20
1986,Gary Lineker,Centre-Forward,25,Barcelona,LaLiga,41,20,0,20
1986,Pietro Paolo Virdis,Centre-Forward,29,Milan,Serie A,28,17,3,20
1986,Frank Mill,Centre-Forward,27,Bor. Dortmund,Bundesliga,31,17,3,20
1986,Bernard Zénier,Centre-Forward,28,FC Metz,Ligue 1,37,18,0,18
1986,Pichi Alonso,Centre-Forward,31,Español,LaLiga2,41,17,0,17
1986,Frank Hartmann,Attacking Midfield,25,1.FC K'lautern,2. Bundesliga,32,17,0,17
1986,Gabriel Calderón,Attacking Midfield,26,Real Betis,LaLiga,26,16,0,16
1986,Harald Kohr,Centre-Forward,24,1.FC K'lautern,2. Bundesliga,27,16,0,16
1986,Jürgen Klinsmann,Centre-Forward,21,VfB Stuttgart,Bundesliga,32,16,0,16
1986,Herbert Waas,Centre-Forward,22,B. Leverkusen,Bundesliga,33,15,1,16
1986,Lothar Matthäus,Defensive Midfield,25,Bayern Munich,Bundesliga,31,14,2,16
1986,Gérard Buscher,Centre-Forward,26,Brest Armorique,Ligue 1,37,15,0,15
1986,Julio Salinas,Centre-Forward,24,Atlético Madrid,LaLiga,38,15,0,15
1986,Klaus Allofs,Centre-Forward,29,1.FC Köln,Bundesliga,33,14,1,15
1986,Alberto Márcico,Second Striker,26,Toulouse,Ligue 1,25,14,1,15
1986,Michael Zorc,Defensive Midfield,23,Bor. Dortmund,Bundesliga,32,14,0,14
1986,Wolfram Wuttke,Second Striker,24,1.FC K'lautern,2. Bundesliga,32,14,0,14
1986,Philippe Fargeon,Second Striker,22,G. Bordeaux,Ligue 2,18,14,0,14
1986,Christian Schreier,Attacking Midfield,27,B. Leverkusen,Bundesliga,33,14,0,14
1986,Carmelo Micciche,Centre-Forward,22,FC Metz,Ligue 1,32,14,0,14
1986,Ramón,Centre-Forward,22,Sevilla FC,LaLiga,34,14,0,14
1986,Enzo Francescoli,Centre-Forward,24,RC Paris,National 2 - Grp. C,35,14,0,14
1986,Enrique Magdaleno,Centre-Forward,30,RCD Mallorca,LaLiga,26,14,0,14
1986,Gianluca Vialli,Centre-Forward,21,Sampdoria,Serie B,28,12,2,14
1986,Emilio Butragueño,Centre-Forward,23,Real Madrid,LaLiga,35,11,3,14
1986,Diego Maradona,Attacking Midfield,25,Napoli,Serie A,29,10,4,14
1986,Jean-Pierre Papin,Centre-Forward,22,Marseille,Ligue 1,33,13,0,13
1986,Michel Pineda,Centre-Forward,22,Español,LaLiga2,40,13,0,13
1986,Philippe Desmet,Attacking Midfield,27,LOSC Lille,Ligue 1,34,13,0,13
1986,Eric Cantona,Second Striker,20,AJ Auxerre,Ligue 2,36,13,0,13
1986,Poli Rincón,Centre-Forward,29,Real Betis,LaLiga,29,13,0,13
1986,Victor Ramos,Attack,27,SC Toulon Var,National 2 - Grp. A,28,13,0,13
1986,Chérif Oudjani,Centre-Forward,21,Lens,Ligue 1,32,13,0,13
1986,Zlatko Vujovic,Centre-Forward,27,G. Bordeaux,Ligue 2,35,12,0,12
1986,Luis Flores,Centre-Forward,24,Sporting Gijón,LaLiga2,31,12,0,12
1986,Thomas von Heesen,Attacking Midfield,24,Hamburger SV,2. Bundesliga,33,12,0,12
1986,Jorge Contreras,Attacking Midfield,25,UD Las Palmas,LaLiga,26,12,0,12
1986,Gérald Passi,Attacking Midfield,22,Toulouse,Ligue 1,37,12,0,12
1986,Alessandro Altobelli,Centre-Forward,30,Inter,Serie A,28,11,1,12
1986,Yannick Stopyra,Centre-Forward,25,Toulouse,Ligue 1,38,11,0,11
1986,Robert Llorens,Attacking Midfield,30,Le Havre AC,Ligue 1,24,11,0,11
1986,Eloy Olaya,Centre-Forward,21,Sporting Gijón,LaLiga2,43,11,0,11
1986,Roland Wohlfarth,Centre-Forward,23,Bayern Munich,Bundesliga,27,11,0,11
1986,José Mari Bakero,Attacking Midfield,23,Real Sociedad,LaLiga,39,11,0,11
1987,Hugo Sánchez,Centre-Forward,28,Real Madrid,LaLiga,36,29,0,29
1987,Diego Maradona,Attacking Midfield,26,Napoli,Serie A,27,15,9,24
1987,Jürgen Klinsmann,Centre-Forward,22,VfB Stuttgart,Bundesliga,34,19,2,21
1987,Jean-Pierre Papin,Centre-Forward,23,Marseille,Ligue 1,37,19,0,19
1987,Ruud Gullit,Attacking Midfield,24,Milan,Serie A,29,9,10,19
1987,Karl-Heinz Riedle,Centre-Forward,21,Werder Bremen,Bundesliga,33,18,0,18
1987,Patrice Garande,Centre-Forward,26,Saint-Étienne,Ligue 2,37,17,0,17
1987,José Mari Bakero,Attacking Midfield,24,Real Sociedad,LaLiga,32,17,0,17
1987,Siegfried Reich,Centre-Forward,27,Hannover 96,2. Bundesliga,34,17,0,17
1987,Lothar Matthäus,Defensive Midfield,26,Bayern Munich,Bundesliga,26,17,0,17
1987,Julio Salinas,Centre-Forward,25,Atlético Madrid,LaLiga,37,16,0,16
1987,Harald Kohr,Centre-Forward,25,1.FC K'lautern,2. Bundesliga,30,16,0,16
1987,Gary Lineker,Centre-Forward,26,Barcelona,LaLiga,36,16,0,16
1987,Fritz Walter,Centre-Forward,26,VfB Stuttgart,Bundesliga,33,16,0,16
1987,Olaf Thon,Central Midfield,21,FC Schalke 04,2. Bundesliga,28,14,2,16
1987,Frank Ordenewitz,Centre-Forward,22,Werder Bremen,Bundesliga,30,15,0,15
1987,Dieter Eckstein,Centre-Forward,23,1.FC Nuremberg,2. Bundesliga,33,15,0,15
1987,Pello Uralde,Right Winger,29,Athletic,LaLiga,38,15,0,15
1987,Joaquín,Attacking Midfield,31,Sporting Gijón,LaLiga2,37,14,0,14
1987,Mark Hateley,Centre-Forward,25,Monaco,Ligue 1,28,14,0,14
1987,Michel,Right Midfield,24,Real Madrid,LaLiga,35,14,0,14
1987,Roberto Baggio,Second Striker,20,Fiorentina,Serie A,27,6,8,14
1987,Michael Zorc,Defensive Midfield,24,Bor. Dortmund,Bundesliga,23,13,0,13
1987,Mo Johnston,Centre-Forward,24,FC Nantes,Ligue 1,32,13,0,13
1987,Uwe Leifeld,Centre-Forward,20,VfL Bochum,Bundesliga,30,13,0,13
1987,Flemming Povlsen,Centre-Forward,20,1.FC Köln,Bundesliga,34,13,0,13
1987,Chérif Oudjani,Centre-Forward,22,Lens,Ligue 1,30,13,0,13
1987,Jürgen Wegmann,Centre-Forward,23,Bayern Munich,Bundesliga,27,13,0,13
1987,Klaus Allofs,Centre-Forward,30,Marseille,Ligue 1,31,13,0,13
1987,Roger Milla,Centre-Forward,35,Montpellier,Ligue 1,33,13,0,13
1987,Careca,Centre-Forward,26,Napoli,Serie A,25,13,0,13
1987,Philippe Fargeon,Second Striker,23,G. Bordeaux,Ligue 2,36,13,0,13
1987,Emilio Butragueño,Centre-Forward,24,Real Madrid,LaLiga,32,12,1,13
1987,Pietro Paolo Virdis,Centre-Forward,30,Milan,Serie A,25,12,1,13
1987,Rubén Sosa,Centre-Forward,21,Real Zaragoza,LaLiga2,22,12,0,12
1987,Philippe Tibeuf,Centre-Forward,25,Saint-Étienne,Ligue 2,31,12,0,12
1987,Uwe Rahn,Attacking Midfield,25,Bor. M'gladbach,Bundesliga,25,12,0,12
1987,Giuseppe Giannini,Attacking Midfield,22,AS Roma,Serie A,28,11,1,12
1987,Lajos Détári,Attacking Midfield,24,E. Frankfurt,Bundesliga,33,11,0,11
1987,Bruno Labbadia,Centre-Forward,21,Hamburger SV,2. Bundesliga,31,11,0,11
1987,Christian Hochstätter,Defensive Midfield,23,Bor. M'gladbach,Bundesliga,32,11,0,11
1987,Erwin Vandenbergh,Centre-Forward,28,LOSC Lille,Ligue 1,30,11,0,11
1987,Roland Wohlfarth,Centre-Forward,24,Bayern Munich,Bundesliga,29,11,0,11
1987,Christian Perez,Attacking Midfield,24,Montpellier,Ligue 1,33,11,0,11
1987,Loren,Centre-Back,20,Real Sociedad,LaLiga,36,11,0,11
1987,Joaquín Villa,Attack,26,Sporting Gijón,LaLiga2,25,11,0,11
1987,Christian Schreier,Attacking Midfield,28,B. Leverkusen,Bundesliga,26,11,0,11
1987,François Omam-Biyik,Centre-Forward,21,Stade Lavallois,Ligue 2,24,11,0,11
1987,Karl-Heinz Bührer,Centre-Forward,27,Waldh. Mannheim,3. Liga,29,11,0,11
1988,Baltazar,Centre-Forward,29,Atlético Madrid,LaLiga,36,35,0,35
1988,Hugo Sánchez,Centre-Forward,29,Real Madrid,LaLiga,35,27,0,27
1988,Marco van Basten,Centre-Forward,23,Milan,Serie A,33,19,8,27
1988,Roland Wohlfarth,Centre-Forward,25,Bayern Munich,Bundesliga,33,18,6,24
1988,Aldo Serena,Centre-Forward,28,Inter,Serie A,32,22,1,23
1988,Jean-Pierre Papin,Centre-Forward,24,Marseille,Ligue 1,36,22,0,22
1988,Uwe Bein,Attacking Midfield,27,Hamburger SV,2. Bundesliga,28,15,7,22
1988,Careca,Centre-Forward,27,Napoli,Serie A,30,19,2,21
1988,Thomas Allofs,Centre-Forward,28,1.FC Köln,Bundesliga,33,17,4,21
1988,Roberto Baggio,Second Striker,21,Fiorentina,Serie A,30,15,6,21
1988,Fritz Walter,Centre-Forward,27,VfB Stuttgart,Bundesliga,33,13,8,21
1988,Jürgen Klinsmann,Centre-Forward,23,VfB Stuttgart,Bundesliga,25,13,8,21
1988,Julio Salinas,Centre-Forward,26,Barcelona,LaLiga,37,20,0,20
1988,Glenn Hoddle,Attacking Midfield,30,Monaco,Ligue 1,32,18,1,19
1988,Stefan Kuntz,Centre-Forward,25,Bay. Uerdingen,Oberliga Niederrhein,33,13,6,19
1988,Jan Furtok,Centre-Forward,26,Hamburger SV,2. Bundesliga,21,9,10,19
1988,Olaf Thon,Central Midfield,22,Bayern Munich,Bundesliga,32,8,11,19
1988,Manfred Bockenfeld,Right-Back,27,Waldh. Mannheim,3. Liga,32,7,12,19
1988,Zlatko Vujovic,Centre-Forward,29,Cannes,National 2 - Grp. A,34,18,0,18
1988,Karl-Heinz Riedle,Centre-Forward,22,Werder Bremen,Bundesliga,33,13,5,18
1988,Andreas Möller,Attacking Midfield,20,Bor. Dortmund,Bundesliga,29,11,7,18
1988,Peter Reichert,Centre-Forward,26,R. Strasbourg,Ligue 1,36,12,5,17
1988,Diego Maradona,Attacking Midfield,27,Napoli,Serie A,26,9,8,17
1988,Wolfram Wuttke,Second Striker,26,1.FC K'lautern,2. Bundesliga,24,7,10,17
1988,Stéphane Paille,Centre-Forward,23,FC Sochaux,Championnat National,35,16,0,16
1988,Frank Neubarth,Centre-Forward,25,Werder Bremen,Bundesliga,27,13,3,16
1988,Jürgen Wegmann,Centre-Forward,24,Bayern Munich,Bundesliga,31,12,4,16
1988,Norbert Dickel,Centre-Forward,26,Bor. Dortmund,Bundesliga,27,12,4,16
1988,Fabrice Mège,Attacking Midfield,23,R. Strasbourg,Ligue 1,35,11,5,16
1988,Günter Breitzke,Right Midfield,21,Bor. Dortmund,Bundesliga,31,10,6,16
1988,Pierre Littbarski,Attacking Midfield,28,1.FC Köln,Bundesliga,30,5,11,16
1988,Emilio Butragueño,Centre-Forward,25,Real Madrid,LaLiga,33,15,0,15
1988,Daniel Bravo,Central Midfield,25,OGC Nice,Ligue 1,29,15,0,15
1988,Daniel Xuereb,Centre-Forward,28,Paris SG,Ligue 1,38,15,0,15
1988,Laurent Blanc,Centre-Back,22,Montpellier,Ligue 1,35,15,0,15
1988,George Weah,Centre-Forward,21,Monaco,Ligue 1,23,14,1,15
1988,Andrea Carnevale,Centre-Forward,27,Napoli,Serie A,28,13,2,15
1988,Hans-Jörg Criens,Centre-Forward,27,Bor. M'gladbach,Bundesliga,32,13,2,15
1988,Thomas von Heesen,Attacking Midfield,26,Hamburger SV,2. Bundesliga,33,9,6,15
1988,Maurizio Gaudino,Attacking Midfield,21,VfB Stuttgart,Bundesliga,30,8,7,15
1988,Marek Lesniak,Centre-Forward,24,B. Leverkusen,Bundesliga,28,7,8,15
1988,Alberico Evani,Left Midfield,25,Milan,Serie A,30,3,12,15
1988,Gianluca Vialli,Centre-Forward,23,Sampdoria,Serie B,30,14,0,14
1988,Fernando,Midfield,22,Valencia,LaLiga,36,14,0,14
1988,Stefano Borgonovo,Centre-Forward,24,Fiorentina,Serie A,30,14,0,14
1988,Fabrice Divert,Centre-Forward,21,SM Caen,Ligue 2,31,14,0,14
1988,Erwin Vandenbergh,Centre-Forward,29,LOSC Lille,Ligue 1,31,14,0,14
1988,Uwe Leifeld,Centre-Forward,21,VfL Bochum,Bundesliga,34,13,1,14
1988,Karl Allgöwer,Central Midfield,31,VfB Stuttgart,Bundesliga,32,12,2,14
1988,Harald Kohr,Centre-Forward,26,1.FC K'lautern,2. Bundesliga,29,12,2,14
1989,Hugo Sánchez,Centre-Forward,30,Real Madrid,LaLiga,35,38,0,38
1989,Toni Polster,Centre-Forward,25,Sevilla FC,LaLiga,35,33,0,33
1989,Jean-Pierre Papin,Centre-Forward,25,Marseille,Ligue 1,36,30,1,31
1989,Diego Maradona,Attacking Midfield,28,Napoli,Serie A,28,16,10,26
1989,Roberto Baggio,Second Striker,22,Fiorentina,Serie A,32,17,5,22
1989,Andreas Möller,Attacking Midfield,21,Bor. Dortmund,Bundesliga,32,10,12,22
1989,Marco van Basten,Centre-Forward,24,Milan,Serie A,26,19,2,21
1989,Jörn Andersen,Centre-Forward,26,E. Frankfurt,Bundesliga,34,18,3,21
1989,Chris Waddle,Attacking Midfield,28,Marseille,Ligue 1,37,9,12,21
1989,Stefan Kuntz,Centre-Forward,26,1.FC K'lautern,2. Bundesliga,32,15,4,19
1989,Jürgen Klinsmann,Centre-Forward,24,Inter,Serie A,31,13,6,19
1989,Lothar Matthäus,Defensive Midfield,28,Inter,Serie A,25,11,8,19
1989,Uwe Bein,Attacking Midfield,28,E. Frankfurt,Bundesliga,33,9,10,19
1989,Aldo Serena,Centre-Forward,29,Inter,Serie A,30,9,10,19
1989,Kálmán Kovács,Centre-Forward,23,AJ Auxerre,Ligue 2,37,18,0,18
1989,Baltazar,Centre-Forward,30,Atlético Madrid,LaLiga,38,18,0,18
1989,Enzo Francescoli,Centre-Forward,27,Marseille,Ligue 1,28,11,7,18
1989,Roby Langers,Centre-Forward,28,OGC Nice,Ligue 1,29,17,0,17
1989,Julio Salinas,Centre-Forward,27,Barcelona,LaLiga,34,15,2,17
1989,Milos Bursac,Centre-Forward,24,SC Toulon Var,National 2 - Grp. A,37,16,0,16
1989,John Aldridge,Centre-Forward,29,Real Sociedad,LaLiga,28,16,0,16
1989,Salvatore Schillaci,Centre-Forward,24,Juventus,Serie A,30,15,1,16
1989,Rudi Völler,Centre-Forward,29,AS Roma,Serie A,32,14,2,16
1989,Roland Wohlfarth,Centre-Forward,26,Bayern Munich,Bundesliga,24,13,3,16
1989,Roberto Mancini,Second Striker,24,Sampdoria,Serie B,31,11,5,16
1989,Wynton Rufer,Centre-Forward,26,Werder Bremen,Bundesliga,34,10,6,16
1989,Pierre Littbarski,Attacking Midfield,29,1.FC Köln,Bundesliga,34,8,8,16
1989,Miguel Pardeza,Second Striker,24,Real Zaragoza,LaLiga2,37,15,0,15
1989,Ramón Díaz,Centre-Forward,29,Monaco,Ligue 1,28,15,0,15
1989,Fabrice Divert,Centre-Forward,22,SM Caen,Ligue 2,38,15,0,15
1989,Ronald Koeman,Sweeper,26,Barcelona,LaLiga,36,14,1,15
1989,Klaus Allofs,Centre-Forward,32,G. Bordeaux,Ligue 2,37,14,0,14
1989,Rafa Martín Vázquez,Attacking Midfield,23,Real Madrid,LaLiga,34,14,0,14
1989,Jean-Marc Ferreri,Attacking Midfield,26,G. Bordeaux,Ligue 2,35,14,0,14
1989,Piet den Boer,Centre-Forward,31,G. Bordeaux,Ligue 2,37,14,0,14
1989,Carlos Muñoz,Attack,27,Real Oviedo,LaLiga2,32,14,0,14
1989,Aziz Bouderbala,Attacking Midfield,28,RC Paris,National 2 - Grp. C,35,14,0,14
1989,Fritz Walter,Centre-Forward,28,VfB Stuttgart,Bundesliga,31,13,1,14
1989,Daniele Massaro,Centre-Forward,28,Milan,Serie A,30,10,4,14
1989,Lyuboslav Penev,Centre-Forward,22,Valencia,LaLiga,27,13,0,13
1989,Gustavo Dezotti,Centre-Forward,25,Cremonese,Serie B,32,13,0,13
1989,Guy Mengual,Attack,29,Cannes,National 2 - Grp. A,33,13,0,13
1989,José Mari Bakero,Attacking Midfield,26,Barcelona,LaLiga,30,13,0,13
1989,Fernando,Midfield,23,Valencia,LaLiga,37,13,0,13
1989,Falko Götz,Attacking Midfield,27,1.FC Köln,Bundesliga,33,11,2,13
1989,Laurent Blanc,Centre-Back,23,Montpellier,Ligue 1,36,12,0,12
1989,Eugène Kabongo,Attack,28,Olympique Lyon,Ligue 1,27,12,0,12
1989,Manolo,Centre-Forward,24,Atlético Madrid,LaLiga,34,12,0,12
1989,Franck Priou,Centre-Forward,25,Mulhouse S-A,France,32,12,0,12
1989,Alberto Márcico,Second Striker,29,Toulouse,Ligue 1,35,12,0,12
1990,Roberto Mancini,Second Striker,25,Sampdoria,Serie B,30,12,19,31
1990,Roland Wohlfarth,Centre-Forward,27,Bayern Munich,Bundesliga,34,21,9,30
1990,Jan Furtok,Centre-Forward,28,Hamburger SV,2. Bundesliga,32,20,6,26
1990,Jean-Pierre Papin,Centre-Forward,26,Marseille,Ligue 1,36,23,1,24
1990,Gianluca Vialli,Centre-Forward,25,Sampdoria,Serie B,26,19,5,24
1990,Andreas Möller,Attacking Midfield,22,E. Frankfurt,Bundesliga,32,16,8,24
1990,Emilio Butragueño,Centre-Forward,27,Real Madrid,LaLiga,35,19,4,23
1990,Uwe Bein,Attacking Midfield,29,E. Frankfurt,Bundesliga,31,8,15,23
1990,Roberto Baggio,Second Striker,23,Juventus,Serie A,33,14,7,21
1990,Wynton Rufer,Centre-Forward,27,Werder Bremen,Bundesliga,33,15,5,20
1990,Brian Laudrup,Right Winger,21,Bayern Munich,Bundesliga,33,9,11,20
1990,Fritz Walter,Centre-Forward,29,VfB Stuttgart,Bundesliga,26,12,7,19
1990,Thomas Allofs,Centre-Forward,30,F. Düsseldorf,2. Bundesliga,32,15,3,18
1990,Souleyman Sané,Centre-Forward,29,Wattenscheid 09,Oberliga Westfalen,33,13,5,18
1990,Marco van Basten,Centre-Forward,25,Milan,Serie A,31,11,7,18
1990,Matthias Sammer,Sweeper,22,VfB Stuttgart,Bundesliga,30,11,7,18
1990,Klaus Allofs,Centre-Forward,33,Werder Bremen,Bundesliga,31,10,8,18
1990,John Aldridge,Centre-Forward,30,Real Sociedad,LaLiga,35,17,0,17
1990,Lothar Matthäus,Defensive Midfield,29,Inter,Serie A,31,16,1,17
1990,Maurice Banach,Centre-Forward,22,1.FC Köln,Bundesliga,31,13,4,17
1990,José Mari Bakero,Attacking Midfield,27,Barcelona,LaLiga,34,13,4,17
1990,Julio Salinas,Centre-Forward,28,Barcelona,LaLiga,33,11,6,17
1990,Milan Luhovy,Centre-Forward,27,Sporting Gijón,LaLiga2,31,16,0,16
1990,Manolo,Centre-Forward,25,Atlético Madrid,LaLiga,37,16,0,16
1990,Kálmán Kovács,Centre-Forward,24,AJ Auxerre,Ligue 2,32,16,0,16
1990,Carlos Aguilera,Centre-Forward,25,Genoa,Serie A,31,15,1,16
1990,Nando,Centre-Forward,23,Hamburger SV,2. Bundesliga,30,11,5,16
1990,Bruno Labbadia,Centre-Forward,24,1.FC K'lautern,2. Bundesliga,22,9,7,16
1990,Manfred Bender,Attacking Midfield,24,Bayern Munich,Bundesliga,33,5,11,16
1990,Luis Enrique,Right Midfield,20,Sporting Gijón,LaLiga2,35,15,0,15
1990,Tomas Skuhravy,Centre-Forward,24,Genoa,Serie A,33,15,0,15
1990,Jürgen Klinsmann,Centre-Forward,25,Inter,Serie A,33,14,1,15
1990,Hans-Jörg Criens,Centre-Forward,29,Bor. M'gladbach,Bundesliga,26,12,3,15
1990,André Golke,Attacking Midfield,25,FC St. Pauli,2. Bundesliga,33,6,9,15
1990,Thomas Doll,Attacking Midfield,24,Hamburger SV,2. Bundesliga,33,4,11,15
1990,François Omam-Biyik,Centre-Forward,24,Stade Rennais,Ligue 1,38,14,0,14
1990,Enzo Scifo,Attacking Midfield,24,AJ Auxerre,Ligue 2,34,14,0,14
1990,Hristo Stoichkov,Left Winger,24,Barcelona,LaLiga,24,14,0,14
1990,Laurent Blanc,Centre-Back,24,Montpellier,Ligue 1,38,14,0,14
1990,Joao Paulo,Attack,25,Bari,Serie B,29,13,1,14
1990,Aljosa Asanovic,Central Midfield,24,FC Metz,Ligue 1,36,13,1,14
1990,Stefan Kuntz,Centre-Forward,27,1.FC K'lautern,2. Bundesliga,27,11,3,14
1990,Rainer Schütterle,Attacking Midfield,24,Karlsruher SC,2. Bundesliga,31,11,3,14
1990,Anthony Yeboah,Centre-Forward,24,E. Frankfurt,Bundesliga,26,8,6,14
1990,Karl Allgöwer,Central Midfield,33,VfB Stuttgart,Bundesliga,32,8,6,14
1990,Frank Hartmann,Attacking Midfield,29,Wattenscheid 09,Oberliga Westfalen,34,8,6,14
1990,Frank Ordenewitz,Centre-Forward,25,1.FC Köln,Bundesliga,31,7,7,14
1990,Chris Waddle,Attacking Midfield,29,Marseille,Ligue 1,35,6,8,14
1990,Armin Eck,Left Midfield,25,Hamburger SV,2. Bundesliga,32,5,9,14
1990,Toni Polster,Centre-Forward,26,Sevilla FC,LaLiga,35,13,0,13
1991,Marco van Basten,Centre-Forward,26,Milan,Serie A,31,25,11,36
1991,Stéphane Chapuisat,Centre-Forward,22,Bor. Dortmund,Bundesliga,37,20,11,31
1991,Jean-Pierre Papin,Centre-Forward,27,Marseille,Ligue 1,37,27,3,30
1991,Manolo,Centre-Forward,26,Atlético Madrid,LaLiga,36,27,0,27
1991,Fritz Walter,Centre-Forward,30,VfB Stuttgart,Bundesliga,38,22,4,26
1991,Marcus Marin,Centre-Forward,24,Stuttg. Kickers,Regionalliga Südwest,32,13,13,26
1991,George Weah,Centre-Forward,24,Monaco,Ligue 1,34,18,7,25
1991,Roberto Baggio,Second Striker,24,Juventus,Serie A,32,18,7,25
1991,Uwe Bein,Attacking Midfield,30,E. Frankfurt,Bundesliga,34,8,16,24
1991,Michael Spies,Attacking Midfield,25,Hansa Rostock,2. Bundesliga,38,13,10,23
1991,Fernando Hierro,Centre-Back,23,Real Madrid,LaLiga,37,21,1,22
1991,Anthony Yeboah,Centre-Forward,25,E. Frankfurt,Bundesliga,34,15,7,22
1991,Andreas Möller,Attacking Midfield,23,E. Frankfurt,Bundesliga,37,12,10,22
1991,Roland Wohlfarth,Centre-Forward,28,Bayern Munich,Bundesliga,29,17,3,20
1991,Maurizio Gaudino,Attacking Midfield,24,VfB Stuttgart,Bundesliga,38,8,12,20
1991,Francois Calderaro,Centre-Forward,27,FC Metz,Ligue 1,36,19,0,19
1991,Jorginho,Right-Back,26,B. Leverkusen,Bundesliga,37,5,14,19
1991,Michael Rummenigge,Attacking Midfield,27,Bor. Dortmund,Bundesliga,36,10,8,18
1991,Hristo Stoichkov,Left Winger,25,Barcelona,LaLiga,32,17,0,17
1991,Francesco Baiano,Second Striker,23,Foggia,Serie C - C,33,16,1,17
1991,Marco Bode,Left Winger,21,Werder Bremen,Bundesliga,32,12,5,17
1991,Bruno Labbadia,Centre-Forward,25,Bayern Munich,Bundesliga,30,10,7,17
1991,Stefan Effenberg,Central Midfield,22,Bayern Munich,Bundesliga,33,10,7,17
1991,Ronald Koeman,Sweeper,28,Barcelona,LaLiga,35,16,0,16
1991,Lothar Sippel,Centre-Forward,26,E. Frankfurt,Bundesliga,32,14,2,16
1991,Michael Tönnies,Centre-Forward,31,MSV Duisburg,3. Liga,33,13,3,16
1991,Frank Ordenewitz,Centre-Forward,26,1.FC Köln,Bundesliga,35,11,5,16
1991,Henri Fuchs,Centre-Forward,21,1.FC Köln,Bundesliga,34,10,6,16
1991,Demir Hotic,Centre-Forward,28,1.FC K'lautern,2. Bundesliga,38,10,6,16
1991,Ruud Gullit,Attacking Midfield,28,Milan,Serie A,26,7,9,16
1991,Careca,Centre-Forward,30,Napoli,Serie A,33,15,0,15
1991,Juan Antonio Pizzi,Centre-Forward,23,CD Tenerife,LaLiga2,34,15,0,15
1991,Fabrice Divert,Centre-Forward,24,Montpellier,Ligue 1,38,14,1,15
1991,Emilio Butragueño,Centre-Forward,28,Real Madrid,LaLiga,35,14,1,15
1991,Dieter Eckstein,Centre-Forward,27,1.FC Nuremberg,2. Bundesliga,36,12,3,15
1991,Dimitrios Moutas,Centre-Forward,23,Stuttg. Kickers,Regionalliga Südwest,32,12,3,15
1991,Ulf Kirsten,Centre-Forward,25,B. Leverkusen,Bundesliga,23,12,3,15
1991,Stefan Kuntz,Centre-Forward,28,1.FC K'lautern,2. Bundesliga,31,11,4,15
1991,Rainer Schütterle,Attacking Midfield,25,Karlsruher SC,2. Bundesliga,31,10,5,15
1991,André Golke,Attacking Midfield,26,1.FC Nuremberg,2. Bundesliga,38,7,8,15
1991,Chris Waddle,Attacking Midfield,30,Marseille,Ligue 1,35,7,8,15
1991,Thomas Kastenmaier,Right-Back,25,Bor. M'gladbach,Bundesliga,38,6,9,15
1991,Mehmet Scholl,Attacking Midfield,20,Karlsruher SC,2. Bundesliga,28,4,11,15
1991,Toni Polster,Centre-Forward,27,CD Logroñés,Spain,38,14,0,14
1991,Stéphane Paille,Centre-Forward,26,SM Caen,Ligue 2,38,14,0,14
1991,Abédi Pelé,Attacking Midfield,26,Marseille,Ligue 1,36,12,2,14
1991,Jörn Andersen,Centre-Forward,28,E. Frankfurt,Bundesliga,35,10,4,14
1991,Matthias Sammer,Sweeper,23,VfB Stuttgart,Bundesliga,33,9,5,14
1991,Daniele Massaro,Centre-Forward,30,Milan,Serie A,32,9,5,14
1991,Flemming Povlsen,Centre-Forward,24,Bor. Dortmund,Bundesliga,38,7,7,14
1992,Teddy Sheringham,Centre-Forward,26,Tottenham,Premier League,41,22,9,31
1992,Eric Cantona,Second Striker,26,Man Utd,Premier League,35,15,15,30
1992,Bebeto,Centre-Forward,28,Dep. La Coruña,Primera Federación - Gr. I,37,29,0,29
1992,Giuseppe Signori,Centre-Forward,24,Lazio,Serie A,32,26,3,29
1992,Roberto Baggio,Second Striker,25,Juventus,Serie A,27,21,7,28
1992,Andreas Thom,Centre-Forward,26,B. Leverkusen,Bundesliga,33,13,14,27
1992,Iván Zamorano,Centre-Forward,25,Real Madrid,LaLiga,34,26,0,26
1992,Anthony Yeboah,Centre-Forward,26,E. Frankfurt,Bundesliga,27,20,6,26
1992,Les Ferdinand,Centre-Forward,25,QPR,Championship,37,20,5,25
1992,Ulf Kirsten,Centre-Forward,26,B. Leverkusen,Bundesliga,33,20,5,25
1992,Brian Deane,Centre-Forward,24,Sheff Utd,Premier League,41,15,10,25
1992,Matt Le Tissier,Attacking Midfield,23,Southampton,Championship,40,15,10,25
1992,Alen Boksic,Centre-Forward,22,Marseille,Ligue 1,37,23,1,24
1992,Rubén Sosa,Centre-Forward,26,Inter,Serie A,28,20,4,24
1992,Andreas Herzog,Attacking Midfield,23,Werder Bremen,Bundesliga,33,10,14,24
1992,Abel Balbo,Centre-Forward,26,Udinese,Serie A,32,21,0,21
1992,Xavier Gravelaine,Centre-Forward,23,SM Caen,Ligue 2,35,20,1,21
1992,Jürgen Klinsmann,Centre-Forward,27,Monaco,Ligue 1,35,19,2,21
1992,Micky Quinn,Centre-Forward,30,Coventry,Championship,26,17,4,21
1992,Uwe Wegmann,Centre-Forward,28,VfL Bochum,Bundesliga,33,13,8,21
1992,Uwe Bein,Attacking Midfield,31,E. Frankfurt,Bundesliga,25,7,14,21
1992,Hristo Stoichkov,Left Winger,26,Barcelona,LaLiga,34,20,0,20
1992,Lyuboslav Penev,Centre-Forward,25,Valencia,LaLiga,34,20,0,20
1992,Dean Holdsworth,Centre-Forward,23,Wimbledon FC,League Two,36,19,1,20
1992,Rudi Völler,Centre-Forward,32,Marseille,Ligue 1,33,18,2,20
1992,Wynton Rufer,Centre-Forward,29,Werder Bremen,Bundesliga,32,17,3,20
1992,Alan Shearer,Centre-Forward,21,Blackburn,Championship,21,16,4,20
1992,David White,Right Winger,24,Man City,Premier League,42,16,4,20
1992,Stéphane Chapuisat,Centre-Forward,23,Bor. Dortmund,Bundesliga,27,15,5,20
1992,Mark Robins,Centre-Forward,22,Norwich,Championship,37,14,6,20
1992,Niall Quinn,Centre-Forward,25,Man City,Premier League,39,9,11,20
1992,Daniel Fonseca,Centre-Forward,22,Napoli,Serie A,31,16,3,19
1992,Ian Wright,Centre-Forward,28,Arsenal,Premier League,31,15,4,19
1992,Maurizio Ganz,Centre-Forward,23,Atalanta,Serie A,32,14,5,19
1992,Gabriel Batistuta,Centre-Forward,23,Fiorentina,Serie A,32,16,2,18
1992,Mark Hughes,Centre-Forward,28,Man Utd,Premier League,41,15,3,18
1992,Dean Saunders,Centre-Forward,28,Aston Villa,Premier League,41,14,4,18
1992,Mike Newell,Centre-Forward,27,Blackburn,Championship,40,13,5,18
1992,Paul Wilkinson,Centre-Forward,27,Middlesbrough,Championship,41,13,5,18
1992,Gianfranco Zola,Second Striker,25,Napoli,Serie A,33,12,6,18
1992,Franck Sauzée,Central Midfield,26,Marseille,Ligue 1,35,12,6,18
1992,Bruno Labbadia,Centre-Forward,26,Bayern Munich,Bundesliga,32,11,7,18
1992,Kevin Gallacher,Right Winger,25,Blackburn,Championship,29,11,7,18
1992,Sergey Kiryakov,Centre-Forward,22,Karlsruher SC,2. Bundesliga,29,11,7,18
1992,Pavel Hapal,Attacking Midfield,22,B. Leverkusen,Bundesliga,30,9,9,18
1992,Cuco Ziganda,Centre-Forward,25,Athletic,LaLiga,36,17,0,17
1992,Luis García,Centre-Forward,23,Atlético Madrid,LaLiga,29,17,0,17
1992,Chris Armstrong,Centre-Forward,21,Crystal Palace,Premier League,35,15,2,17
1992,Lee Chapman,Centre-Forward,32,Leeds,Championship,40,15,2,17
1992,Roberto Mancini,Second Striker,27,Sampdoria,Serie B,30,15,2,17
1993,Andy Cole,Centre-Forward,21,Newcastle,Premier League,40,34,13,47
1993,Romário,Centre-Forward,27,Barcelona,LaLiga,33,30,8,38
1993,Chris Sutton,Centre-Forward,20,Norwich,Championship,41,25,11,36
1993,Alan Shearer,Centre-Forward,22,Blackburn,Championship,40,31,4,35
1993,Matt Le Tissier,Attacking Midfield,24,Southampton,Championship,38,25,9,34
1993,Eric Cantona,Second Striker,27,Man Utd,Premier League,34,18,12,30
1993,Peter Beardsley,Second Striker,32,Newcastle,Premier League,35,21,8,29
1993,Ian Wright,Centre-Forward,29,Arsenal,Premier League,39,23,3,26
1993,Youri Djorkaeff,Attacking Midfield,25,Monaco,Ligue 1,35,20,5,25
1993,Mark Bright,Centre-Forward,31,Sheff Wed,Championship,40,19,6,25
1993,Stéphane Chapuisat,Centre-Forward,24,Bor. Dortmund,Bundesliga,30,17,8,25
1993,Hristo Stoichkov,Left Winger,27,Barcelona,LaLiga,34,16,9,25
1993,Davor Suker,Centre-Forward,25,Sevilla FC,LaLiga,34,24,0,24
1993,Roger Boli,Centre-Forward,27,Lens,Ligue 1,35,20,4,24
1993,Anthony Yeboah,Centre-Forward,27,E. Frankfurt,Bundesliga,22,18,6,24
1993,Les Ferdinand,Centre-Forward,26,QPR,Championship,36,16,8,24
1993,Marek Lesniak,Centre-Forward,29,Wattenscheid 09,Oberliga Westfalen,31,13,11,24
1993,Giuseppe Signori,Centre-Forward,25,Lazio,Serie A,24,23,0,23
1993,Meho Kodro,Centre-Forward,26,Real Sociedad,LaLiga,34,23,0,23
1993,Nicolas Ouédec,Centre-Forward,21,FC Nantes,Ligue 1,38,20,3,23
1993,Dean Holdsworth,Centre-Forward,24,Wimbledon FC,League Two,42,17,6,23
1993,Roberto Baggio,Second Striker,26,Juventus,Serie A,32,17,6,23
1993,Rod Wallace,Right Winger,23,Leeds,Championship,37,17,6,23
1993,Brian Deane,Centre-Forward,25,Leeds,Championship,41,11,12,23
1993,Ingo Anderbrügge,Left Midfield,29,FC Schalke 04,2. Bundesliga,34,9,12,21
1993,Stefan Kuntz,Centre-Forward,30,1.FC K'lautern,2. Bundesliga,26,18,2,20
1993,Franck Priou,Centre-Forward,29,Cannes,National 2 - Grp. A,32,18,2,20
1993,Toni Polster,Centre-Forward,29,1.FC Köln,Bundesliga,25,17,3,20
1993,Rubén Sosa,Centre-Forward,27,Inter,Serie A,28,16,4,20
1993,Sonny Anderson,Centre-Forward,22,Marseille,Ligue 1,20,16,4,20
1993,Ryan Giggs,Left Midfield,19,Man Utd,Premier League,38,13,7,20
1993,Ulf Kirsten,Centre-Forward,27,B. Leverkusen,Bundesliga,28,13,7,20
1993,Rodolfo Cardoso,Attacking Midfield,24,SC Freiburg,Bundesliga,33,12,8,20
1993,Ruel Fox,Right Winger,25,Newcastle,Premier League,39,9,11,20
1993,Ciriaco Sforza,Central Midfield,23,1.FC K'lautern,2. Bundesliga,29,8,12,20
1993,Gianfranco Zola,Second Striker,26,AC Parma,Serie B,33,18,1,19
1993,Paulo Sérgio,Right Winger,24,B. Leverkusen,Bundesliga,32,17,2,19
1993,Tony Cottee,Centre-Forward,27,Everton,Premier League,39,16,3,19
1993,Kevin Campbell,Centre-Forward,23,Arsenal,Premier League,37,15,4,19
1993,Karsten Bäron,Centre-Forward,20,Hamburger SV,2. Bundesliga,32,13,6,19
1993,Julen Guerrero,Attacking Midfield,19,Athletic,LaLiga,36,18,0,18
1993,Ruud Gullit,Attacking Midfield,30,Sampdoria,Serie B,31,15,3,18
1993,Alain Caveglia,Second Striker,25,FC Sochaux,Championnat National,38,14,4,18
1993,Teddy Sheringham,Centre-Forward,27,Tottenham,Premier League,19,13,5,18
1993,David Ginola,Left Winger,26,Paris SG,Ligue 1,38,13,5,18
1993,Christophe Lagrange,Attack,26,Angers SCO,Ligue 2,37,12,6,18
1993,Mark Hughes,Centre-Forward,29,Man Utd,Premier League,36,12,6,18
1993,Mehmet Scholl,Attacking Midfield,22,Bayern Munich,Bundesliga,27,11,7,18
1993,Paul Ince,Defensive Midfield,25,Man Utd,Premier League,39,8,10,18
1993,Bernd Schuster,Attacking Midfield,33,B. Leverkusen,Bundesliga,28,5,13,18
1994,Alan Shearer,Centre-Forward,23,Blackburn,Championship,42,34,13,47
1994,Matt Le Tissier,Attacking Midfield,25,Southampton,Championship,41,19,15,34
1994,Robbie Fowler,Centre-Forward,19,Liverpool,Premier League,42,25,8,33
1994,Les Ferdinand,Centre-Forward,27,QPR,Championship,37,24,9,33
1994,Mario Basler,Right Midfield,25,Werder Bremen,Bundesliga,33,20,12,32
1994,Jürgen Klinsmann,Centre-Forward,29,Tottenham,Premier League,41,20,11,31
1994,Iván Zamorano,Centre-Forward,27,Real Madrid,LaLiga,38,28,2,30
1994,Stan Collymore,Centre-Forward,23,Nottm Forest,Premier League,37,22,7,29
1994,Rudi Völler,Centre-Forward,34,B. Leverkusen,Bundesliga,30,16,13,29
1994,Gabriel Batistuta,Centre-Forward,25,Fiorentina,Serie A,32,26,1,27
1994,Patrice Loko,Centre-Forward,24,FC Nantes,Ligue 1,37,22,5,27
1994,Teddy Sheringham,Centre-Forward,28,Tottenham,Premier League,42,18,9,27
1994,Gianluca Vialli,Centre-Forward,29,Juventus,Serie A,30,17,9,26
1994,Rodolfo Cardoso,Attacking Midfield,25,SC Freiburg,Bundesliga,30,16,10,26
1994,Bryan Roy,Left Winger,24,Nottm Forest,Premier League,37,13,13,26
1994,Andreas Herzog,Attacking Midfield,25,Werder Bremen,Bundesliga,31,10,16,26
1994,Meho Kodro,Centre-Forward,27,Real Sociedad,LaLiga,35,25,0,25
1994,Andy Cole,Centre-Forward,22,Man Utd,Premier League,36,21,4,25
1994,Chris Sutton,Centre-Forward,21,Blackburn,Championship,40,15,10,25
1994,Abel Balbo,Centre-Forward,28,AS Roma,Serie A,32,22,2,24
1994,Toni Polster,Centre-Forward,30,1.FC Köln,Bundesliga,32,17,7,24
1994,Andreas Möller,Attacking Midfield,26,Bor. Dortmund,Bundesliga,30,14,10,24
1994,Heiko Herrlich,Centre-Forward,22,Bor. M'gladbach,Bundesliga,32,20,3,23
1994,Nicolas Ouédec,Centre-Forward,22,FC Nantes,Ligue 1,34,18,5,23
1994,Fabrizio Ravanelli,Centre-Forward,25,Juventus,Serie A,33,15,8,23
1994,Uwe Spies,Centre-Forward,26,SC Freiburg,Bundesliga,34,13,10,23
1994,Alain Caveglia,Second Striker,26,Le Havre AC,Ligue 1,34,20,2,22
1994,Marco Simone,Second Striker,25,Milan,Serie A,30,17,5,22
1994,Florian Maurice,Centre-Forward,20,Olympique Lyon,Ligue 1,34,15,6,21
1994,Japhet N'Doram,Centre-Forward,28,FC Nantes,Ligue 1,32,12,9,21
1994,Ruel Fox,Right Winger,26,Newcastle,Premier League,40,10,11,21
1994,Anthony Yeboah,Centre-Forward,28,E. Frankfurt,Bundesliga,32,19,1,20
1994,Pavel Kuka,Centre-Forward,25,1.FC K'lautern,2. Bundesliga,34,16,4,20
1994,Youri Djorkaeff,Attacking Midfield,26,Monaco,Ligue 1,33,14,6,20
1994,Dejan Savicevic,Attacking Midfield,27,Milan,Serie A,19,9,11,20
1994,Gianfranco Zola,Second Striker,27,AC Parma,Serie B,32,19,0,19
1994,Ruggiero Rizzitelli,Centre-Forward,26,Torino,Serie A,32,19,0,19
1994,Giuseppe Signori,Centre-Forward,26,Lazio,Serie A,27,17,2,19
1994,Ardian Kozniku,Centre-Forward,26,Cannes,National 2 - Grp. A,31,13,6,19
1994,Kevin Gallen,Centre-Forward,18,QPR,Championship,37,10,9,19
1994,Christophe Dugarry,Centre-Forward,22,G. Bordeaux,Ligue 2,32,9,10,19
1994,Franck Gava,Left Midfield,24,Olympique Lyon,Ligue 1,35,9,10,19
1994,Darren Anderton,Right Midfield,22,Tottenham,Premier League,37,5,14,19
1994,Ian Wright,Centre-Forward,30,Arsenal,Premier League,31,18,0,18
1994,Uwe Rösler,Centre-Forward,25,Man City,Premier League,31,15,3,18
1994,Stefan Kuntz,Centre-Forward,31,1.FC K'lautern,2. Bundesliga,28,14,4,18
1994,Peter Beardsley,Second Striker,33,Newcastle,Premier League,34,13,5,18
1994,Stéphane Chapuisat,Centre-Forward,25,Bor. Dortmund,Bundesliga,20,12,6,18
1994,Sonny Anderson,Centre-Forward,23,Monaco,Ligue 1,23,11,7,18
1994,David Zitelli,Centre-Forward,25,FC Metz,Ligue 1,31,9,9,18
1995,Alan Shearer,Centre-Forward,24,Blackburn,Championship,35,31,4,35
1995,Predrag Mijatović,Centre-Forward,26,Valencia,LaLiga,40,28,6,34
1995,Robbie Fowler,Centre-Forward,20,Liverpool,Premier League,38,28,5,33
1995,Juan Antonio Pizzi,Centre-Forward,27,CD Tenerife,LaLiga2,41,31,0,31
1995,Les Ferdinand,Centre-Forward,28,Newcastle,Premier League,37,25,6,31
1995,Giuseppe Signori,Centre-Forward,27,Lazio,Serie A,31,24,2,26
1995,Giovane Élber,Centre-Forward,22,VfB Stuttgart,Bundesliga,33,16,10,26
1995,Bebeto,Centre-Forward,31,Dep. La Coruña,Primera Federación - Gr. I,34,25,0,25
1995,Stan Collymore,Centre-Forward,24,Liverpool,Premier League,31,14,11,25
1995,Eric Cantona,Second Striker,29,Man Utd,Premier League,30,14,11,25
1995,George Weah,Centre-Forward,28,Milan,Serie A,26,11,14,25
1995,Igor Protti,Centre-Forward,27,Bari,Serie B,33,24,0,24
1995,Teddy Sheringham,Centre-Forward,29,Tottenham,Premier League,38,16,8,24
1995,Enrico Chiesa,Centre-Forward,24,Sampdoria,Serie B,27,22,1,23
1995,Alen Peternac,Centre-Forward,23,Real Valladolid,LaLiga2,38,22,0,22
1995,Harald Spörl,Right Midfield,28,Hamburger SV,2. Bundesliga,32,14,8,22
1995,Sonny Anderson,Centre-Forward,24,Monaco,Ligue 1,34,21,0,21
1995,Anto Drobnjak,Centre-Forward,26,SC Bastia,Ligue 2,36,20,1,21
1995,Dwight Yorke,Centre-Forward,23,Aston Villa,Premier League,35,17,4,21
1995,Chris Armstrong,Centre-Forward,24,Tottenham,Premier League,36,15,6,21
1995,Ryan Giggs,Left Midfield,21,Man Utd,Premier League,33,11,10,21
1995,Andreas Möller,Attacking Midfield,27,Bor. Dortmund,Bundesliga,23,8,13,21
1995,Steve McManaman,Right Midfield,23,Liverpool,Premier League,38,6,15,21
1995,Raúl,Second Striker,18,Real Madrid,LaLiga,40,19,1,20
1995,Gabriel Batistuta,Centre-Forward,26,Fiorentina,Serie A,31,19,0,19
1995,Florian Maurice,Centre-Forward,21,Olympique Lyon,Ligue 1,36,19,0,19
1995,Marco Branca,Centre-Forward,30,Inter,Serie A,31,19,0,19
1995,Fabrizio Ravanelli,Centre-Forward,26,Juventus,Serie A,26,12,7,19
1995,Mario Basler,Right Midfield,26,Werder Bremen,Bundesliga,30,11,8,19
1995,Roberto Baggio,Second Striker,28,Milan,Serie A,28,7,12,19
1995,Julio Salinas,Centre-Forward,33,Sporting Gijón,LaLiga2,38,18,0,18
1995,Sean Dundee,Centre-Forward,22,Karlsruher SC,2. Bundesliga,32,16,2,18
1995,Andrey Kanchelskis,Right Midfield,26,Everton,Premier League,32,16,2,18
1995,Jürgen Klinsmann,Centre-Forward,30,Bayern Munich,Bundesliga,32,16,2,18
1995,Michael Zorc,Defensive Midfield,32,Bor. Dortmund,Bundesliga,30,15,3,18
1995,Martin Dahlin,Centre-Forward,27,Bor. M'gladbach,Bundesliga,23,15,3,18
1995,Olaf Bodden,Centre-Forward,27,1860 Munich,3. Liga,31,14,4,18
1995,Mehmet Scholl,Attacking Midfield,24,Bayern Munich,Bundesliga,30,10,8,18
1995,Thomas Häßler,Attacking Midfield,29,Karlsruher SC,2. Bundesliga,34,8,10,18
1995,Fredi Bobic,Centre-Forward,23,VfB Stuttgart,Bundesliga,26,17,0,17
1995,Oliver Bierhoff,Centre-Forward,27,Udinese,Serie A,31,17,0,17
1995,Jordi Lardín,Left Winger,22,Espanyol,LaLiga2,37,17,0,17
1995,Dennis Bergkamp,Second Striker,26,Arsenal,Premier League,33,11,6,17
1995,Andy Cole,Centre-Forward,23,Man Utd,Premier League,34,11,6,17
1995,Ingo Anderbrügge,Left Midfield,31,FC Schalke 04,2. Bundesliga,27,9,8,17
1995,Peter Beardsley,Second Striker,34,Newcastle,Premier League,35,8,9,17
1995,Piotr Nowak,Attacking Midfield,30,1860 Munich,3. Liga,27,7,10,17
1995,Lyuboslav Penev,Centre-Forward,28,Atlético Madrid,LaLiga,37,16,0,16
1995,Davor Suker,Centre-Forward,27,Sevilla FC,LaLiga,32,16,0,16
1995,John Spencer,Centre-Forward,24,Chelsea,Premier League,28,13,3,16
1996,Ronaldo,Centre-Forward,19,Barcelona,LaLiga,37,34,10,44
1996,Alan Shearer,Centre-Forward,25,Newcastle,Premier League,31,25,7,32
1996,Fredi Bobic,Centre-Forward,24,VfB Stuttgart,Bundesliga,33,19,11,30
1996,Raúl,Second Striker,19,Real Madrid,LaLiga,42,21,8,29
1996,Giovane Élber,Centre-Forward,23,VfB Stuttgart,Bundesliga,31,17,11,28
1996,Filippo Inzaghi,Centre-Forward,22,Atalanta BC,Serie A,33,24,3,27
1996,Davor Suker,Centre-Forward,28,Real Madrid,LaLiga,38,24,3,27
1996,Dariusz Wosz,Attacking Midfield,27,VfL Bochum,Bundesliga,32,9,17,26
1996,Alfonso,Centre-Forward,23,Real Betis,LaLiga,41,25,0,25
1996,Les Ferdinand,Centre-Forward,29,Newcastle,Premier League,31,16,9,25
1996,Jürgen Klinsmann,Centre-Forward,31,Bayern Munich,Bundesliga,33,15,10,25
1996,Ian Wright,Centre-Forward,32,Arsenal,Premier League,35,23,1,24
1996,Vincenzo Montella,Centre-Forward,22,Sampdoria,Serie B,28,22,2,24
1996,Ulf Kirsten,Centre-Forward,30,B. Leverkusen,Bundesliga,29,22,2,24
1996,Toni Polster,Centre-Forward,32,1.FC Köln,Bundesliga,32,21,3,24
1996,Robbie Fowler,Centre-Forward,21,Liverpool,Premier League,32,18,5,23
1996,Krasimir Balakov,Attacking Midfield,30,VfB Stuttgart,Bundesliga,31,13,10,23
1996,Eric Cantona,Second Striker,30,Man Utd,Premier League,36,11,12,23
1996,Stéphane Guivarc'h,Centre-Forward,25,Stade Rennais,Ligue 1,36,22,0,22
1996,Rivaldo,Second Striker,24,Dep. La Coruña,Primera Federación - Gr. I,41,21,1,22
1996,Ole Gunnar Solskjaer,Centre-Forward,23,Man Utd,Premier League,33,18,4,22
1996,Sean Dundee,Centre-Forward,23,Karlsruher SC,2. Bundesliga,29,17,5,22
1996,Paulo Sérgio,Right Winger,27,B. Leverkusen,Bundesliga,33,17,5,22
1996,Andreas Herzog,Attacking Midfield,27,Werder Bremen,Bundesliga,29,15,7,22
1996,Japhet N'Doram,Centre-Forward,30,FC Nantes,Ligue 1,35,21,0,21
1996,Sonny Anderson,Centre-Forward,25,Monaco,Ligue 1,34,19,2,21
1996,Oli,Centre-Forward,24,Real Oviedo,LaLiga2,41,20,0,20
1996,Abel Balbo,Centre-Forward,30,AS Roma,Serie A,30,17,3,20
1996,Alain Caveglia,Second Striker,28,Olympique Lyon,Ligue 1,32,19,0,19
1996,David Zitelli,Centre-Forward,27,R. Strasbourg,Ligue 1,35,19,0,19
1996,Luis Enrique,Right Midfield,26,Barcelona,LaLiga,35,17,2,19
1996,Bernhard Winkler,Centre-Forward,30,1860 Munich,3. Liga,27,17,2,19
1996,Roberto Mancini,Second Striker,31,Sampdoria,Serie B,33,15,4,19
1996,Youri Djorkaeff,Attacking Midfield,28,Inter,Serie A,33,14,5,19
1996,Predrag Mijatović,Centre-Forward,27,Real Madrid,LaLiga,38,14,5,19
1996,Stéphane Chapuisat,Centre-Forward,27,Bor. Dortmund,Bundesliga,30,13,6,19
1996,George Weah,Centre-Forward,29,Milan,Serie A,28,13,6,19
1996,Andreas Möller,Attacking Midfield,28,Bor. Dortmund,Bundesliga,26,5,14,19
1996,Anto Drobnjak,Centre-Forward,27,SC Bastia,Ligue 2,33,18,0,18
1996,Fabrizio Ravanelli,Centre-Forward,27,Middlesbrough,Championship,33,16,2,18
1996,Jonathan Akpoborie,Centre-Forward,27,Hansa Rostock,2. Bundesliga,31,14,4,18
1996,Marco Bode,Left Winger,26,Werder Bremen,Bundesliga,33,10,8,18
1996,Mario Basler,Right Midfield,27,Bayern Munich,Bundesliga,27,8,10,18
1996,Dwight Yorke,Centre-Forward,24,Aston Villa,Premier League,37,17,0,17
1996,Christopher Ohen,Centre-Forward,25,SD Compostela,Segunda Federación - Gr. I,33,17,0,17
1996,Cuco Ziganda,Centre-Forward,29,Athletic,LaLiga,42,17,0,17
1996,Patrice Loko,Centre-Forward,26,Paris SG,Ligue 1,38,16,1,17
1996,Ion Vladoiu,Centre-Forward,27,1.FC Köln,Bundesliga,28,8,9,17
1996,Juan Esnáider,Centre-Forward,23,Atlético Madrid,LaLiga,35,16,0,16
1996,Jean-Pierre Papin,Centre-Forward,32,G. Bordeaux,Ligue 2,32,16,0,16
1997,Alessandro Del Piero,Second Striker,22,Juventus,Serie A,32,21,12,33
1997,Oliver Bierhoff,Centre-Forward,29,Udinese,Serie A,32,27,4,31
1997,Roberto Baggio,Second Striker,30,Bologna,Serie A,30,22,9,31
1997,Michael Owen,Centre-Forward,17,Liverpool,Premier League,36,18,12,30
1997,Ronaldo,Centre-Forward,20,Inter,Serie A,32,25,3,28
1997,Dion Dublin,Centre-Forward,28,Coventry,Championship,36,18,10,28
1997,Gabriel Batistuta,Centre-Forward,28,Fiorentina,Serie A,31,21,6,27
1997,Dennis Bergkamp,Second Striker,28,Arsenal,Premier League,28,16,11,27
1997,Ulf Kirsten,Centre-Forward,31,B. Leverkusen,Bundesliga,27,22,4,26
1997,Christian Vieri,Centre-Forward,23,Atlético Madrid,LaLiga,24,24,1,25
1997,Krasimir Balakov,Attacking Midfield,31,VfB Stuttgart,Bundesliga,31,11,14,25
1997,Olaf Marschall,Centre-Forward,31,1.FC K'lautern,2. Bundesliga,24,21,3,24
1997,John Hartson,Centre-Forward,22,West Ham,Premier League,32,15,9,24
1997,Thomas Häßler,Attacking Midfield,31,Karlsruher SC,2. Bundesliga,34,12,12,24
1997,Vincenzo Montella,Centre-Forward,23,Sampdoria,Serie B,33,20,3,23
1997,David Beckham,Right Midfield,22,Man Utd,Premier League,37,9,14,23
1997,Stéphane Guivarc'h,Centre-Forward,26,AJ Auxerre,Ligue 2,32,21,1,22
1997,Filippo Inzaghi,Centre-Forward,23,Juventus,Serie A,31,18,4,22
1997,Andy Cole,Centre-Forward,25,Man Utd,Premier League,33,15,7,22
1997,Stéphane Chapuisat,Centre-Forward,28,Bor. Dortmund,Bundesliga,27,14,8,22
1997,Rivaldo,Second Striker,25,Barcelona,LaLiga,34,19,2,21
1997,Chris Sutton,Centre-Forward,24,Blackburn,Championship,35,18,3,21
1997,Luis Enrique,Right Midfield,27,Barcelona,LaLiga,34,18,2,20
1997,Luis Oliveira,Centre-Forward,28,Fiorentina,Serie A,33,15,5,20
1997,Francesco Totti,Second Striker,20,AS Roma,Serie A,30,13,7,20
1997,Steve McManaman,Right Midfield,25,Liverpool,Premier League,36,11,9,20
1997,Giovane Élber,Centre-Forward,24,Bayern Munich,Bundesliga,28,11,9,20
1997,Eyal Berkovic,Attacking Midfield,25,West Ham,Premier League,35,7,13,20
1997,Kennet Andersson,Centre-Forward,29,Bologna,Serie A,32,12,7,19
1997,Teddy Sheringham,Centre-Forward,31,Man Utd,Premier League,31,9,10,19
1997,David Trézéguet,Centre-Forward,19,Monaco,Ligue 1,27,18,0,18
1997,Dario Hübner,Centre-Forward,30,Brescia,Serie B,30,16,2,18
1997,Kevin Gallacher,Right Winger,30,Blackburn,Championship,33,16,2,18
1997,Toni Polster,Centre-Forward,33,1.FC Köln,Bundesliga,33,13,5,18
1997,Darko Kovacevic,Centre-Forward,23,Real Sociedad,LaLiga,33,17,0,17
1997,Jimmy Floyd Hasselbaink,Centre-Forward,25,Leeds,Championship,33,16,1,17
1997,Carmine Esposito,Centre-Forward,26,Empoli,Serie A,32,14,3,17
1997,Michael Preetz,Centre-Forward,29,Hertha BSC,2. Bundesliga,32,14,3,17
1997,Jörgen Pettersson,Left Winger,21,Bor. M'gladbach,Bundesliga,33,13,4,17
1997,Carsten Jancker,Centre-Forward,22,Bayern Munich,Bundesliga,29,13,4,17
1997,Marc Overmars,Left Winger,24,Arsenal,Premier League,32,12,5,17
1997,Francesco Baiano,Second Striker,29,Derby,League One,33,12,5,17
1997,Ryan Giggs,Left Midfield,23,Man Utd,Premier League,29,8,9,17
1997,Victor Ikpeba,Centre-Forward,24,Monaco,Ligue 1,30,16,0,16
1997,Lyuboslav Penev,Centre-Forward,30,SD Compostela,Segunda Federación - Gr. I,34,16,0,16
1997,Darren Huckerby,Right Winger,21,Coventry,Championship,34,14,2,16
1997,Fredi Bobic,Centre-Forward,25,VfB Stuttgart,Bundesliga,29,13,3,16
1997,Paolo Di Canio,Centre-Forward,28,Sheff Wed,Championship,35,12,4,16
1997,Dwight Yorke,Centre-Forward,25,Aston Villa,Premier League,30,12,4,16
1997,Enrico Chiesa,Centre-Forward,26,AC Parma,Serie B,33,10,6,16
1998,Rivaldo,Second Striker,26,Barcelona,LaLiga,37,24,16,40
1998,Oliver Bierhoff,Centre-Forward,30,Milan,Serie A,34,19,11,30
1998,Márcio Amoroso,Centre-Forward,23,Udinese,Serie A,33,22,7,29
1998,Dwight Yorke,Centre-Forward,26,Man Utd,Premier League,33,18,11,29
1998,Jimmy Floyd Hasselbaink,Centre-Forward,26,Leeds,Championship,36,18,11,29
1998,Patrick Kluivert,Centre-Forward,22,Barcelona,LaLiga,35,15,14,29
1998,Claudio López,Centre-Forward,23,Valencia,LaLiga,32,21,7,28
1998,Michael Preetz,Centre-Forward,30,Hertha BSC,2. Bundesliga,34,23,4,27
1998,Sylvain Wiltord,Second Striker,24,G. Bordeaux,Ligue 2,33,22,4,26
1998,Raúl,Second Striker,21,Real Madrid,LaLiga,37,25,0,25
1998,Dennis Bergkamp,Second Striker,29,Arsenal,Premier League,29,12,13,25
1998,Gabriel Batistuta,Centre-Forward,29,Fiorentina,Serie A,28,21,3,24
1998,Luís Figo,Right Winger,25,Barcelona,LaLiga,34,7,17,24
1998,Fernando Morientes,Centre-Forward,22,Real Madrid,LaLiga,33,19,3,22
1998,Michael Owen,Centre-Forward,18,Liverpool,Premier League,30,18,4,22
1998,Nicolas Anelka,Centre-Forward,19,Arsenal,Premier League,35,17,5,22
1998,Carsten Jancker,Centre-Forward,23,Bayern Munich,Bundesliga,26,13,9,22
1998,Francesco Totti,Second Striker,21,AS Roma,Serie A,31,12,10,22
1998,Ulf Kirsten,Centre-Forward,32,B. Leverkusen,Bundesliga,31,19,2,21
1998,Marco Delvecchio,Centre-Forward,25,AS Roma,Serie A,31,18,3,21
1998,Oliver Neuville,Centre-Forward,25,Hansa Rostock,2. Bundesliga,33,14,7,21
1998,Roberto Muzzi,Centre-Forward,26,Cagliari Calcio,Serie A,32,16,4,20
1998,Lilian Laslandes,Centre-Forward,26,G. Bordeaux,Ligue 2,33,15,5,20
1998,Giovane Élber,Centre-Forward,25,Bayern Munich,Bundesliga,21,13,7,20
1998,Andrzej Juskowiak,Centre-Forward,27,VfL Wolfsburg,Bundesliga,31,13,7,20
1998,Phillip Cocu,Defensive Midfield,27,Barcelona,LaLiga,36,12,8,20
1998,Álvaro Recoba,Second Striker,22,Inter,Serie A,20,10,10,20
1998,Enrico Chiesa,Centre-Forward,27,AC Parma,Serie B,30,9,11,20
1998,Julio Dely Valdés,Centre-Forward,31,Real Oviedo,LaLiga2,37,19,0,19
1998,Andy Cole,Centre-Forward,26,Man Utd,Premier League,32,17,2,19
1998,Savo Milosevic,Centre-Forward,24,Real Zaragoza,LaLiga2,35,17,2,19
1998,Hernán Crespo,Centre-Forward,22,AC Parma,Serie B,30,16,3,19
1998,Simone Inzaghi,Centre-Forward,22,Piacenza,Serie D - B,30,15,4,19
1998,Marcelo Salas,Centre-Forward,23,Lazio,Serie A,30,15,4,19
1998,Alan Shearer,Centre-Forward,27,Newcastle,Premier League,30,14,5,19
1998,Siniša Mihajlović,Centre-Back,29,Lazio,Serie A,30,8,11,19
1998,Marco Bode,Left Winger,28,Werder Bremen,Bundesliga,29,8,11,19
1998,Marc Overmars,Left Winger,25,Arsenal,Premier League,37,6,13,19
1998,Ismael Urzaiz,Centre-Forward,26,Athletic,LaLiga,36,16,2,18
1998,Fabrizio Ravanelli,Centre-Forward,29,Marseille,Ligue 1,29,13,5,18
1998,Rui Costa,Attacking Midfield,26,Fiorentina,Serie A,31,10,8,18
1998,David Beckham,Right Midfield,23,Man Utd,Premier League,34,6,12,18
1998,Alain Caveglia,Second Striker,30,Olympique Lyon,Ligue 1,29,17,0,17
1998,Giuseppe Signori,Centre-Forward,30,Bologna,Serie A,28,15,2,17
1998,Turu Flores,Centre-Forward,27,Dep. La Coruña,Primera Federación - Gr. I,36,14,3,17
1998,Anthony Yeboah,Centre-Forward,32,Hamburger SV,2. Bundesliga,34,14,3,17
1998,Markus Beierle,Centre-Forward,26,MSV Duisburg,3. Liga,28,13,4,17
1998,Paulo Sérgio,Right Winger,29,AS Roma,Serie A,30,12,5,17
1998,Toni Polster,Centre-Forward,34,Bor. M'gladbach,Bundesliga,31,11,6,17
1998,Edmundo,Second Striker,27,Fiorentina,Serie A,28,8,9,17
1999,Kevin Phillips,Centre-Forward,25,Sunderland,Championship,36,30,0,30
1999,Alan Shearer,Centre-Forward,28,Newcastle,Premier League,37,23,7,30
1999,Salva Ballesta,Centre-Forward,24,Racing,LaLiga2,36,27,2,29
1999,Hernán Crespo,Centre-Forward,23,AC Parma,Serie B,34,22,7,29
1999,Andriy Shevchenko,Centre-Forward,22,Milan,Serie A,32,24,4,28
1999,Jardel,Centre-Forward,25,FC Porto,Liga Portugal,19,25,1,26
1999,Jimmy Floyd Hasselbaink,Centre-Forward,27,Atlético Madrid,LaLiga,34,24,1,25
1999,Gabriel Batistuta,Centre-Forward,30,Fiorentina,Serie A,30,23,2,25
1999,Thierry Henry,Centre-Forward,21,Arsenal,Premier League,31,17,8,25
1999,Raúl,Second Striker,22,Real Madrid,LaLiga,34,17,8,25
1999,Catanha,Centre-Forward,27,Málaga CF,Primera Federación - Gr. II,33,24,0,24
1999,Marco Simone,Second Striker,30,Monaco,Ligue 1,34,21,3,24
1999,Dwight Yorke,Centre-Forward,27,Man Utd,Premier League,32,20,4,24
1999,Paolo Di Canio,Centre-Forward,30,West Ham,Premier League,30,16,8,24
1999,Sonny Anderson,Centre-Forward,28,Olympique Lyon,Ligue 1,32,23,0,23
1999,Roy Makaay,Centre-Forward,24,Dep. La Coruña,Primera Federación - Gr. I,36,22,1,23
1999,Andy Cole,Centre-Forward,27,Man Utd,Premier League,28,19,4,23
1999,Alessandro Del Piero,Second Striker,24,Juventus,Serie A,34,9,14,23
1999,David Trézéguet,Centre-Forward,21,Monaco,Ligue 1,30,22,0,22
1999,Michael Bridges,Centre-Forward,20,Leeds,Championship,34,19,3,22
1999,Vincenzo Montella,Centre-Forward,25,AS Roma,Serie A,31,18,4,22
1999,Aílton,Centre-Forward,25,Werder Bremen,Bundesliga,29,12,10,22
1999,Savo Milosevic,Centre-Forward,25,Real Zaragoza,LaLiga2,37,21,0,21
1999,Martin Max,Centre-Forward,30,1860 Munich,3. Liga,32,19,2,21
1999,Marco Ferrante,Centre-Forward,28,Torino,Serie A,30,18,3,21
1999,Giuseppe Signori,Centre-Forward,31,Bologna,Serie A,31,15,6,21
1999,David Beckham,Right Midfield,24,Man Utd,Premier League,31,6,15,21
1999,Ulf Kirsten,Centre-Forward,33,B. Leverkusen,Bundesliga,27,17,3,20
1999,Patrick Kluivert,Centre-Forward,23,Barcelona,LaLiga,26,15,5,20
1999,Gaizka Mendieta,Right Midfield,25,Valencia,LaLiga,33,13,7,20
1999,Paulo Sérgio,Right Winger,30,Bayern Munich,Bundesliga,28,13,7,20
1999,Claudio López,Centre-Forward,24,Valencia,LaLiga,34,11,9,20
1999,Markus Weissenberger,Attacking Midfield,24,Arm. Bielefeld,3. Liga,33,9,11,20
1999,Ebbe Sand,Centre-Forward,26,FC Schalke 04,2. Bundesliga,32,14,5,19
1999,Sylvain Wiltord,Second Striker,25,G. Bordeaux,Ligue 2,32,13,6,19
1999,Ole Gunnar Solskjaer,Centre-Forward,26,Man Utd,Premier League,28,12,7,19
1999,Stefan Beinlich,Attacking Midfield,27,B. Leverkusen,Bundesliga,29,11,8,19
1999,Juan Sebastián Verón,Central Midfield,24,Lazio,Serie A,31,8,11,19
1999,Francesco Totti,Second Striker,22,AS Roma,Serie A,27,7,12,19
1999,Diego Tristán,Centre-Forward,23,RCD Mallorca,LaLiga,35,18,0,18
1999,Filippo Inzaghi,Centre-Forward,25,Juventus,Serie A,33,15,3,18
1999,Álvaro Recoba,Second Striker,23,Inter,Serie A,27,10,8,18
1999,Stefano Fiore,Attacking Midfield,24,Udinese,Serie A,33,9,9,18
1999,Thomas Häßler,Attacking Midfield,33,1860 Munich,3. Liga,33,8,10,18
1999,Ryan Giggs,Left Midfield,25,Man Utd,Premier League,30,6,12,18
1999,Christian,Centre-Forward,24,Paris SG,Ligue 1,29,16,1,17
1999,Alex Dias,Centre-Forward,27,Saint-Étienne,Ligue 2,29,15,2,17
1999,Lilian Laslandes,Centre-Forward,27,G. Bordeaux,Ligue 2,31,14,3,17
1999,Christian Vieri,Centre-Forward,25,Inter,Serie A,19,13,4,17
1999,Roberto Muzzi,Centre-Forward,27,Udinese,Serie A,29,12,5,17
2000,Rivaldo,Second Striker,28,Barcelona,LaLiga,35,23,10,33
2000,Ebbe Sand,Centre-Forward,27,FC Schalke 04,2. Bundesliga,33,22,10,32
2000,Hernán Crespo,Centre-Forward,24,Lazio,Serie A,32,26,3,29
2000,Andriy Shevchenko,Centre-Forward,23,Milan,Serie A,34,24,4,28
2000,Raúl,Second Striker,23,Real Madrid,LaLiga,36,24,3,27
2000,Sergej Barbarez,Second Striker,28,Hamburger SV,2. Bundesliga,31,22,5,27
2000,Javi Moreno,Centre-Forward,25,Alavés,LaLiga,34,22,5,27
2000,Luís Figo,Right Winger,27,Real Madrid,LaLiga,34,9,18,27
2000,Claudio Pizarro,Centre-Forward,21,Werder Bremen,Bundesliga,31,19,7,26
2000,Thierry Henry,Centre-Forward,22,Arsenal,Premier League,35,17,9,26
2000,Jimmy Floyd Hasselbaink,Centre-Forward,28,Chelsea,Premier League,35,23,1,24
2000,Patrick Kluivert,Centre-Forward,24,Barcelona,LaLiga,31,18,6,24
2000,Emile Mpenza,Centre-Forward,21,FC Schalke 04,2. Bundesliga,27,13,11,24
2000,Sonny Anderson,Centre-Forward,29,Olympique Lyon,Ligue 1,29,22,1,23
2000,Enrico Chiesa,Centre-Forward,29,Fiorentina,Serie A,30,22,1,23
2000,Pena,Centre-Forward,26,FC Porto,Liga Portugal,29,22,0,22
2000,Giuseppe Signori,Centre-Forward,32,Bologna,Serie A,23,16,6,22
2000,Vasile Miriuta,Attacking Midfield,31,Energie Cottbus,Regionalliga Nordost,29,11,11,22
2000,Gabriel Batistuta,Centre-Forward,31,AS Roma,Serie A,28,20,1,21
2000,Christian Vieri,Centre-Forward,26,Inter,Serie A,27,18,3,21
2000,Giovane Élber,Centre-Forward,27,Bayern Munich,Bundesliga,27,15,6,21
2000,David Beckham,Right Midfield,25,Man Utd,Premier League,31,9,12,21
2000,Pierre van Hooijdonk,Centre-Forward,30,Benfica,Liga Portugal,30,20,0,20
2000,Pauleta,Centre-Forward,27,G. Bordeaux,Ligue 2,28,20,0,20
2000,Diego Tristán,Centre-Forward,24,Dep. La Coruña,Primera Federación - Gr. I,29,19,1,20
2001,Jardel,Centre-Forward,27,Sporting CP,Liga Portugal,30,42,5,47
2001,Dario Hübner,Centre-Forward,34,Piacenza,Serie D - B,33,24,6,30
2001,Thierry Henry,Centre-Forward,23,Arsenal,Premier League,33,24,6,30
2001,David Trézéguet,Centre-Forward,23,Juventus,Serie A,34,24,5,29
2001,Jimmy Floyd Hasselbaink,Centre-Forward,29,Chelsea,Premier League,35,23,6,29
2001,Patrick Kluivert,Centre-Forward,25,Barcelona,LaLiga,33,18,11,29
2001,João Pinto,Second Striker,29,Sporting CP,Liga Portugal,33,9,20,29
2001,Ruud van Nistelrooy,Centre-Forward,25,Man Utd,Premier League,32,23,5,28
2001,Alan Shearer,Centre-Forward,30,Newcastle,Premier League,37,23,4,27
2001,Christian Vieri,Centre-Forward,27,Inter,Serie A,25,22,5,27
2001,Marco Di Vaio,Centre-Forward,24,AC Parma,Serie B,33,20,6,26
2001,Javier Saviola,Second Striker,19,Barcelona,LaLiga,36,17,9,26
2001,Deco,Attacking Midfield,23,FC Porto,Liga Portugal,30,13,13,26
2001,Michael Ballack,Central Midfield,24,B. Leverkusen,Bundesliga,29,17,8,25
2001,Alessandro Del Piero,Second Striker,26,Juventus,Serie A,32,16,9,25
2001,Pauleta,Centre-Forward,28,G. Bordeaux,Ligue 2,33,22,2,24
2001,Márcio Amoroso,Centre-Forward,26,Bor. Dortmund,Bundesliga,31,18,6,24
2001,Ole Gunnar Solskjaer,Centre-Forward,28,Man Utd,Premier League,30,17,7,24
2001,Raúl,Second Striker,24,Real Madrid,LaLiga,35,14,10,24
2001,Simão,Left Winger,21,Benfica,Liga Portugal,26,11,13,24
2001,Robert Pirès,Left Midfield,27,Arsenal,Premier League,28,9,15,24
2001,Derlei,Centre-Forward,25,Leiria,Liga Sabseg,33,22,1,23
2001,Michael Owen,Centre-Forward,21,Liverpool,Premier League,29,19,4,23
2001,Miroslav Klose,Centre-Forward,23,1.FC K'lautern,2. Bundesliga,31,16,7,23
2001,Djibril Cissé,Centre-Forward,19,AJ Auxerre,Ligue 2,29,22,0,22
2001,Fernando Morientes,Centre-Forward,25,Real Madrid,LaLiga,33,18,4,22
2001,Martin Max,Centre-Forward,32,1860 Munich,3. Liga,28,18,4,22
2001,Aílton,Centre-Forward,27,Werder Bremen,Bundesliga,33,16,6,22
2001,Pierre-Alain Frau,Centre-Forward,21,FC Sochaux,Championnat National,29,14,8,22
2001,Eugenio Corini,Defensive Midfield,30,Chievo Verona,Italy,30,9,13,22
2001,Laurent Robert,Left Winger,26,Newcastle,Premier League,37,8,14,22
2001,Diego Tristán,Centre-Forward,25,Dep. La Coruña,Primera Federación - Gr. I,34,21,0,21
2001,Filippo Maniero,Centre-Forward,28,AC Venezia 1907,Serie B,31,18,3,21
2001,Giovane Élber,Centre-Forward,28,Bayern Munich,Bundesliga,30,17,4,21
2001,Cristiano Doni,Attacking Midfield,28,Atalanta BC,Serie A,30,16,5,21
2001,Eidur Gudjohnsen,Centre-Forward,22,Chelsea,Premier League,32,14,7,21
2001,Oliver Neuville,Centre-Forward,28,B. Leverkusen,Bundesliga,33,13,8,21
2001,Dennis Bergkamp,Second Striker,32,Arsenal,Premier League,33,9,12,21
2001,Zé Roberto,Left Midfield,26,B. Leverkusen,Bundesliga,30,4,17,21
2001,Thomas Häßler,Attacking Midfield,35,1860 Munich,3. Liga,29,6,14,20
2001,Jean-Claude Darcheville,Centre-Forward,25,FC Lorient,Ligue 1,32,19,0,19
2001,Jan Koller,Centre-Forward,28,Bor. Dortmund,Bundesliga,33,11,8,19
2001,David Beckham,Right Midfield,26,Man Utd,Premier League,28,11,8,19
2001,Fary Faye,Centre-Forward,26,Beira-Mar,Portugal,31,18,0,18
2001,Robbie Fowler,Centre-Forward,26,Leeds,Championship,32,15,3,18
2001,Vincenzo Montella,Centre-Forward,27,AS Roma,Serie A,19,13,5,18
2001,Andy Cole,Centre-Forward,29,Blackburn,Championship,26,13,5,18
2001,Marcelinho Paraíba,Attacking Midfield,26,Hertha BSC,2. Bundesliga,33,13,5,18
2001,Arie van Lent,Centre-Forward,30,Bor. M'gladbach,Bundesliga,30,12,6,18
2001,Michael Preetz,Centre-Forward,33,Hertha BSC,2. Bundesliga,34,12,6,18
2002,Thierry Henry,Centre-Forward,24,Arsenal,Premier League,37,24,25,49
2002,Simão,Left Winger,22,Benfica,Liga Portugal,33,18,13,31
2002,Adrian Mutu,Centre-Forward,23,AC Parma,Serie B,31,18,12,30
2002,Roy Makaay,Centre-Forward,27,Dep. La Coruña,Primera Federación - Gr. I,38,29,0,29
2002,Claudio López,Centre-Forward,27,Lazio,Serie A,34,15,14,29
2002,Deco,Attacking Midfield,24,FC Porto,Liga Portugal,30,10,19,29
2002,Ruud van Nistelrooy,Centre-Forward,26,Man Utd,Premier League,34,25,3,28
2002,Ronaldo,Centre-Forward,25,Real Madrid,LaLiga,31,23,5,28
2002,Raúl,Second Striker,25,Real Madrid,LaLiga,31,16,12,28
2002,Giovane Élber,Centre-Forward,29,Bayern Munich,Bundesliga,33,21,6,27
2002,Shabani Nonda,Centre-Forward,25,Monaco,Ligue 1,35,26,0,26
2002,Pauleta,Centre-Forward,29,G. Bordeaux,Ligue 2,37,23,3,26
2002,Alessandro Del Piero,Second Striker,27,Juventus,Serie A,24,16,10,26
2002,Nihat Kahveci,Centre-Forward,22,Real Sociedad,LaLiga,35,23,2,25
2002,Thomas Christiansen,Centre-Forward,29,VfL Bochum,Bundesliga,34,21,4,25
2002,Patrick Kluivert,Centre-Forward,26,Barcelona,LaLiga,36,16,9,25
2002,Marcelinho Paraíba,Attacking Midfield,27,Hertha BSC,2. Bundesliga,33,14,11,25
2002,Christian Vieri,Centre-Forward,28,Inter,Serie A,23,24,0,24
2002,James Beattie,Centre-Forward,24,Southampton,Championship,38,23,1,24
2002,Darko Kovacevic,Centre-Forward,28,Real Sociedad,LaLiga,36,20,4,24
2002,Michael Owen,Centre-Forward,22,Liverpool,Premier League,35,19,5,24
2002,Javi Guerrero,Centre-Forward,25,Racing,LaLiga2,35,15,9,24
2002,Kevin Kuranyi,Centre-Forward,20,VfB Stuttgart,Bundesliga,32,15,9,24
2002,Luís Figo,Right Winger,29,Real Madrid,LaLiga,33,10,14,24
2002,Aílton,Centre-Forward,28,Werder Bremen,Bundesliga,31,16,7,23
2002,Mark Viduka,Centre-Forward,26,Leeds,Championship,33,20,2,22
2002,Fary Faye,Centre-Forward,27,Beira-Mar,Portugal,31,18,3,21
2002,Alan Shearer,Centre-Forward,31,Newcastle,Premier League,35,17,4,21
2002,Filippo Inzaghi,Centre-Forward,28,Milan,Serie A,30,17,4,21
2002,Gianfranco Zola,Second Striker,35,Chelsea,Premier League,38,14,7,21
2002,Zinédine Zidane,Attacking Midfield,30,Real Madrid,LaLiga,33,9,12,21
2002,Didier Drogba,Centre-Forward,24,Guingamp,Ligue 2,34,17,3,20
2002,Claudio Pizarro,Centre-Forward,23,Bayern Munich,Bundesliga,31,15,5,20
2002,Javier Saviola,Second Striker,20,Barcelona,LaLiga,36,13,7,20
2002,Benjamin Lauth,Centre-Forward,20,1860 Munich,3. Liga,32,13,7,20
2002,Roberto Baggio,Second Striker,35,Brescia,Serie B,32,12,8,20
2002,Robert Pirès,Left Midfield,28,Arsenal,Premier League,26,15,4,19
2002,Markus Schroth,Centre-Forward,27,1860 Munich,3. Liga,32,14,5,19
2002,Hélder Postiga,Centre-Forward,19,FC Porto,Liga Portugal,31,13,6,19
2002,Jimmy Floyd Hasselbaink,Centre-Forward,30,Chelsea,Premier League,36,11,8,19
2002,Pavel Nedved,Left Midfield,29,Juventus,Serie A,29,9,10,19
2002,Álvaro Recoba,Second Striker,26,Inter,Serie A,27,9,10,19
2002,Ole Gunnar Solskjaer,Centre-Forward,29,Man Utd,Premier League,37,9,10,19
2002,Adriano,Centre-Forward,20,AC Parma,Serie B,28,15,3,18
2002,Harry Kewell,Left Winger,23,Leeds,Championship,31,14,4,18
2002,Francesco Totti,Second Striker,25,AS Roma,Serie A,24,14,4,18
2002,Paul Scholes,Central Midfield,27,Man Utd,Premier League,33,14,4,18
2002,Tomislav Maric,Centre-Forward,29,VfL Wolfsburg,Bundesliga,27,12,6,18
2002,Dário,Centre-Forward,25,Coimbra,Liga 3,30,11,7,18
2002,Paul Freier,Right Midfield,22,VfL Bochum,Bundesliga,32,7,11,18
2003,Thierry Henry,Centre-Forward,25,Arsenal,Premier League,37,30,6,36
2003,Aílton,Centre-Forward,29,Werder Bremen,Bundesliga,33,28,8,36
2003,Ronaldo,Centre-Forward,26,Real Madrid,LaLiga,32,24,9,33
2003,Djibril Cissé,Centre-Forward,21,AJ Auxerre,Ligue 2,38,26,2,28
2003,Andriy Shevchenko,Centre-Forward,26,AC Milan,Serie A,32,24,3,27
2003,Roy Makaay,Centre-Forward,28,Bayern Munich,Bundesliga,32,23,4,27
2003,Martin Max,Centre-Forward,34,Hansa Rostock,2. Bundesliga,33,20,7,27
2003,França,Centre-Forward,27,B. Leverkusen,Bundesliga,33,14,13,27
2003,Alberto Gilardino,Centre-Forward,20,AC Parma,Serie B,34,23,3,26
2003,Alan Shearer,Centre-Forward,32,Newcastle,Premier League,37,22,4,26
2003,Louis Saha,Centre-Forward,24,Man Utd,Premier League,32,20,6,26
2003,Francesco Totti,Second Striker,26,AS Roma,Serie A,31,20,6,26
2003,Didier Drogba,Centre-Forward,25,Marseille,Ligue 1,35,19,7,26
2003,Pierre-Alain Frau,Centre-Forward,23,FC Sochaux,Championnat National,36,17,8,25
2003,Dimitar Berbatov,Centre-Forward,22,B. Leverkusen,Bundesliga,33,16,9,25
2003,Javier Chevantón,Centre-Forward,22,Lecce,Serie A,31,19,5,24
2003,Ivan Klasnic,Centre-Forward,23,Werder Bremen,Bundesliga,29,13,11,24
2003,Mista,Centre-Forward,24,Valencia,LaLiga,33,19,4,23
2003,Antonio Cassano,Second Striker,20,AS Roma,Serie A,33,14,9,23
2003,Robert Pirès,Left Midfield,29,Arsenal,Premier League,36,14,9,23
2003,Ruud van Nistelrooy,Centre-Forward,27,Man Utd,Premier League,32,20,2,22
2003,Derlei,Centre-Forward,27,FC Porto,Liga Portugal,18,13,9,22
2003,Roberto Baggio,Second Striker,36,Brescia,Serie B,26,12,10,22
2003,Benni McCarthy,Centre-Forward,25,FC Porto,Liga Portugal,29,20,1,21
2003,Adriano,Centre-Forward,21,Inter,Serie A,25,17,4,21
2003,Vahid Hashemian,Centre-Forward,26,VfL Bochum,Bundesliga,32,16,5,21
2003,Ewerthon,Centre-Forward,22,Bor. Dortmund,Bundesliga,31,16,5,21
2003,Jan Koller,Centre-Forward,30,Bor. Dortmund,Bundesliga,32,16,5,21
2003,David Trézéguet,Centre-Forward,25,Juventus,Serie A,25,16,5,21
2003,Ronaldinho,Left Winger,23,Barcelona,LaLiga,32,15,6,21
2003,Alex Frei,Centre-Forward,23,Stade Rennais,Ligue 1,28,20,0,20
2003,Júlio Baptista,Attacking Midfield,21,Sevilla FC,LaLiga,30,20,0,20
2003,Fernando Torres,Centre-Forward,19,Atlético Madrid,LaLiga,35,20,0,20
2003,Adriano,Centre-Forward,24,Nacional,Liga Sabseg,29,18,2,20
2003,Pauleta,Centre-Forward,30,Paris SG,Ligue 1,37,18,2,20
2003,Nicolas Anelka,Centre-Forward,24,Man City,Premier League,32,16,4,20
2003,Michael Owen,Centre-Forward,23,Liverpool,Premier League,29,16,4,20
2003,James Beattie,Centre-Forward,25,Southampton,Championship,37,14,6,20
2003,Michael Ballack,Central Midfield,26,Bayern Munich,Bundesliga,28,7,13,20
2003,Raúl Tamudo,Centre-Forward,25,Espanyol,LaLiga2,32,19,0,19
2003,Salva Ballesta,Centre-Forward,28,Málaga CF,Primera Federación - Gr. II,34,18,1,19
2003,David Villa,Centre-Forward,21,Real Zaragoza,LaLiga2,38,17,2,19
2003,Yakubu Aiyegbeni,Centre-Forward,20,Portsmouth,League One,37,16,3,19
2003,Diego Klimowicz,Centre-Forward,28,VfL Wolfsburg,Bundesliga,33,15,4,19
2003,Santos,Centre-Forward,24,FC Sochaux,Championnat National,29,14,5,19
2003,Vicente,Left Winger,21,Valencia,LaLiga,33,12,7,19
2003,Mancini,Left Winger,22,AS Roma,Serie A,33,8,11,19
2003,Luís Figo,Right Winger,30,Real Madrid,LaLiga,36,8,11,19
2003,Deco,Attacking Midfield,25,FC Porto,Liga Portugal,28,2,17,19
2003,Mikael Forssell,Centre-Forward,22,Birmingham,Championship,32,17,1,18
2004,Thierry Henry,Centre-Forward,26,Arsenal,Premier League,32,25,14,39
2004,Roy Makaay,Centre-Forward,29,Bayern Munich,Bundesliga,33,22,13,35
2004,Marcelinho Paraíba,Attacking Midfield,29,Hertha BSC,2. Bundesliga,32,18,13,31
2004,Samuel Eto'o,Centre-Forward,23,Barcelona,LaLiga,37,25,5,30
2004,Marek Mintal,Attacking Midfield,26,1.FC Nuremberg,2. Bundesliga,34,24,5,29
2004,Ronaldo,Centre-Forward,27,Real Madrid,LaLiga,34,21,8,29
2004,Frank Lampard,Central Midfield,26,Chelsea,Premier League,38,13,16,29
2004,Luca Toni,Centre-Forward,27,US Palermo,Serie B,35,20,7,27
2004,Diego Forlán,Centre-Forward,25,Villarreal,LaLiga,39,25,1,26
2004,Cristiano Lucarelli,Centre-Forward,28,AS Livorno,Serie D - E,35,24,2,26
2004,Vincenzo Montella,Centre-Forward,30,AS Roma,Serie A,37,21,5,26
2004,Liedson,Centre-Forward,26,Sporting CP,Liga Portugal,31,24,1,25
2004,Alberto Gilardino,Centre-Forward,21,Parma,Serie B,38,23,2,25
2004,Dimitar Berbatov,Centre-Forward,23,B. Leverkusen,Bundesliga,33,20,5,25
2004,Miroslav Klose,Centre-Forward,26,Werder Bremen,Bundesliga,32,15,10,25
2004,Martin Petrov,Left Winger,25,VfL Wolfsburg,Bundesliga,30,12,13,25
2004,Ricardo Oliveira,Centre-Forward,24,Real Betis,LaLiga,37,22,2,24
2004,Zlatan Ibrahimović,Centre-Forward,22,Juventus,Serie A,35,16,8,24
2004,Ronaldinho,Left Winger,24,Barcelona,LaLiga,35,9,15,24
2004,Andriy Shevchenko,Centre-Forward,27,AC Milan,Serie A,29,17,6,23
2004,Andy Johnson,Centre-Forward,23,Crystal Palace,Premier League,37,21,1,22
2004,Alex Frei,Centre-Forward,24,Stade Rennais,Ligue 1,36,20,2,22
2004,Lincoln,Attacking Midfield,25,FC Schalke 04,2. Bundesliga,31,12,10,22
2004,Enrico Chiesa,Centre-Forward,33,AC Siena,Italy,36,11,11,22
2004,Simão,Left Winger,24,Benfica,Liga Portugal,34,15,6,21
2005,Miroslav Klose,Centre-Forward,27,Werder Bremen,Bundesliga,26,25,13,38
2005,Luca Toni,Centre-Forward,28,Fiorentina,Serie A,38,31,6,37
2005,Thierry Henry,Centre-Forward,27,Arsenal,Premier League,32,27,8,35
2005,Ronaldinho,Left Winger,25,Barcelona,LaLiga,29,17,18,35
2005,Samuel Eto'o,Centre-Forward,24,Barcelona,LaLiga,34,26,7,33
2005,Dimitar Berbatov,Centre-Forward,24,B. Leverkusen,Bundesliga,34,21,9,30
2005,David Villa,Centre-Forward,23,Valencia,LaLiga,37,25,3,28
2005,David Trézéguet,Centre-Forward,27,Juventus,Serie A,32,23,4,27
2005,Didier Drogba,Centre-Forward,27,Chelsea,Premier League,29,12,15,27
2005,Andriy Shevchenko,Centre-Forward,28,AC Milan,Serie A,28,19,7,26
2005,Pauleta,Centre-Forward,32,Paris SG,Ligue 1,36,21,4,25
2005,Wayne Rooney,Centre-Forward,19,Man Utd,Premier League,36,16,9,25
2005,David Suazo,Centre-Forward,25,Cagliari Calcio,Serie A,37,22,2,24
2005,Ruud van Nistelrooy,Centre-Forward,29,Man Utd,Premier League,35,21,3,24
2005,Frank Lampard,Central Midfield,27,Chelsea,Premier League,35,16,8,24
2005,Francesco Totti,Second Striker,28,AS Roma,Serie A,24,15,9,24
2005,Marcelinho Paraíba,Attacking Midfield,30,Hertha BSC,2. Bundesliga,32,12,12,24
2005,Halil Altintop,Attacking Midfield,22,1.FC K'lautern,2. Bundesliga,34,20,3,23
2005,Alberto Gilardino,Centre-Forward,22,AC Milan,Serie A,34,17,6,23
2005,Ivan Klasnic,Centre-Forward,25,Werder Bremen,Bundesliga,30,15,8,23
2005,Kaká,Attacking Midfield,23,AC Milan,Serie A,35,14,9,23
2005,Sergej Barbarez,Second Striker,33,Hamburger SV,2. Bundesliga,33,10,13,23
2005,Roy Makaay,Centre-Forward,30,Bayern Munich,Bundesliga,31,17,5,22
2005,Liedson,Centre-Forward,27,Sporting CP,Liga Portugal,31,15,7,22
2005,Juninho Pernambucano,Attacking Midfield,30,Olympique Lyon,Ligue 1,32,9,13,22
2005,Johan Micoud,Attacking Midfield,31,Werder Bremen,Bundesliga,30,8,14,22
2005,Robert Vittek,Centre-Forward,23,1.FC Nuremberg,2. Bundesliga,30,16,5,21
2005,Tim Borowski,Central Midfield,25,Werder Bremen,Bundesliga,31,10,11,21
2005,Olivier Monterrubio,Left Winger,28,Stade Rennais,Ligue 1,32,5,16,21
2005,Cristiano Lucarelli,Centre-Forward,29,AS Livorno,Serie D - E,36,19,1,20
2005,Sylvain Wiltord,Second Striker,31,Olympique Lyon,Ligue 1,35,12,8,20
2005,Oliver Neuville,Centre-Forward,32,Bor. M'gladbach,Bundesliga,34,10,10,20
2005,Zinédine Zidane,Attacking Midfield,33,Real Madrid,LaLiga,29,9,11,20
2005,Massimo Oddo,Right-Back,29,Lazio,Serie A,35,7,13,20
2005,Francesco Tavano,Centre-Forward,26,Empoli,Serie A,37,19,0,19
2005,Darren Bent,Centre-Forward,21,Charlton,League One,36,18,1,19
2005,Robbie Keane,Centre-Forward,24,Tottenham,Premier League,36,16,3,19
2005,Nuno Gomes,Centre-Forward,28,Benfica,Liga Portugal,29,15,4,19
2005,Peter Odemwingie,Right Winger,23,LOSC Lille,Ligue 1,26,14,5,19
2005,Daniel Cousin,Centre-Forward,28,Lens,Ligue 1,33,13,6,19
2005,Lukas Podolski,Second Striker,20,1.FC Köln,Bundesliga,32,12,7,19
2005,Thomas Kahlenberg,Central Midfield,22,AJ Auxerre,Ligue 2,38,8,11,19
2005,Albert Meyong,Centre-Forward,24,Belenenses,Liga Sabseg,26,17,1,18
2005,Tommaso Rocchi,Centre-Forward,27,Lazio,Serie A,37,16,2,18
2005,Michael Ballack,Central Midfield,28,Bayern Munich,Bundesliga,26,14,4,18
2005,Ebi Smolarek,Centre-Forward,24,Bor. Dortmund,Bundesliga,34,13,5,18
2005,Yakubu Aiyegbeni,Centre-Forward,22,Middlesbrough,Championship,34,13,5,18
2005,Michael Thurk,Centre-Forward,29,1.FSV Mainz 05,Bundesliga,32,12,6,18
2005,Boubacar Sanogo,Centre-Forward,22,1.FC K'lautern,2. Bundesliga,24,10,8,18
2005,Julio Cruz,Centre-Forward,30,Inter,Serie A,31,15,2,17
2006,Francesco Totti,Second Striker,29,AS Roma,Serie A,35,26,8,34
2006,Ronaldinho,Left Winger,26,Barcelona,LaLiga,32,21,9,30
2006,Miroslav Klose,Centre-Forward,28,Werder Bremen,Bundesliga,31,13,15,28
2006,Ruud van Nistelrooy,Centre-Forward,30,Real Madrid,LaLiga,37,25,2,27
2006,Diego,Attacking Midfield,21,Werder Bremen,Bundesliga,33,13,14,27
2006,Kevin Kuranyi,Centre-Forward,24,FC Schalke 04,2. Bundesliga,34,15,11,26
2006,Wayne Rooney,Centre-Forward,20,Man Utd,Premier League,35,14,12,26
2006,Cristiano Ronaldo,Centre-Forward,21,Man Utd,Premier League,34,17,8,25
2006,Didier Drogba,Centre-Forward,28,Chelsea,Premier League,36,20,4,24
2006,Theofanis Gekas,Centre-Forward,26,VfL Bochum,Bundesliga,32,20,4,24
2006,Adrian Mutu,Centre-Forward,27,Fiorentina,Serie A,33,16,8,24
2006,Ricardo Quaresma,Right Winger,22,FC Porto,Liga Portugal,26,6,17,23
2006,Diego Milito,Centre-Forward,27,Real Zaragoza,LaLiga2,37,22,0,22
2006,Frédéric Kanouté,Centre-Forward,28,Sevilla FC,LaLiga,32,21,1,22
2006,Tommaso Rocchi,Centre-Forward,28,Lazio,Serie A,36,16,6,22
2006,Juninho Pernambucano,Attacking Midfield,31,Olympique Lyon,Ligue 1,31,10,12,22
2006,Cristiano Lucarelli,Centre-Forward,30,AS Livorno,Serie D - E,34,20,1,21
2006,Nicola Amoruso,Centre-Forward,31,Reggina,Serie D - I,34,17,4,21
2006,Roy Makaay,Centre-Forward,31,Bayern Munich,Bundesliga,33,16,5,21
2006,Alex Frei,Centre-Forward,26,Bor. Dortmund,Bundesliga,32,16,5,21
2006,Zlatan Ibrahimović,Centre-Forward,24,Inter,Serie A,27,15,6,21
2006,Mario Gómez,Centre-Forward,20,VfB Stuttgart,Bundesliga,25,14,7,21
2006,Dimitar Berbatov,Centre-Forward,25,Tottenham,Premier League,33,12,9,21
2006,Frank Lampard,Central Midfield,28,Chelsea,Premier League,37,11,10,21
2006,Christian Riganó,Centre-Forward,32,Messina Peloro,Serie C - C,27,19,1,20
2006,Diego Forlán,Centre-Forward,27,Villarreal,LaLiga,36,19,1,20
2006,Rolando Bianchi,Centre-Forward,23,Reggina,Serie D - I,37,18,2,20
2006,Luca Toni,Centre-Forward,29,Fiorentina,Serie A,29,16,4,20
2006,Sergiu Radu,Centre-Forward,28,Energie Cottbus,Regionalliga Nordost,34,14,5,19
2006,Vincenzo Iaquinta,Centre-Forward,26,Udinese,Serie A,30,14,5,19
2006,Mamadou Niang,Centre-Forward,26,Marseille,Ligue 1,37,12,7,19
2006,Samuel Eto'o,Centre-Forward,25,Barcelona,LaLiga,19,11,8,19
2006,Florent Malouda,Left Winger,26,Olympique Lyon,Ligue 1,35,10,9,19
2006,Benni McCarthy,Centre-Forward,28,Blackburn,Championship,36,18,0,18
2006,Gionatha Spinesi,Centre-Forward,28,Catania,Serie C - C,32,17,1,18
2006,Liedson,Centre-Forward,28,Sporting CP,Liga Portugal,28,15,3,18
2006,Marko Pantelic,Centre-Forward,27,Hertha BSC,2. Bundesliga,32,14,4,18
2006,Igor Budan,Centre-Forward,26,Parma,Serie B,35,13,5,18
2006,Cristiano Doni,Attacking Midfield,33,Atalanta BC,Serie A,26,13,5,18
2006,Simão,Left Winger,26,Benfica,Liga Portugal,24,11,7,18
2006,Nicolas Anelka,Centre-Forward,27,Bolton,League One,35,11,7,18
2006,Vlad Munteanu,Left Midfield,25,Energie Cottbus,Regionalliga Nordost,33,11,7,18
2006,Antonio Di Natale,Centre-Forward,28,Udinese,Serie A,31,11,7,18
2006,Frédéric Piquionne,Centre-Forward,27,Saint-Étienne,Ligue 2,32,10,8,18
2006,Mikel Arteta,Central Midfield,24,Everton,Premier League,35,9,9,18
2006,David Villa,Centre-Forward,24,Valencia,LaLiga,37,15,2,17
2006,Pauleta,Centre-Forward,33,Paris SG,Ligue 1,33,15,2,17
2006,Mark Viduka,Centre-Forward,30,Middlesbrough,Championship,29,14,3,17
2006,Steve Savidan,Centre-Forward,28,Valenciennes FC,Ligue 2,34,13,4,17
2006,Cacau,Centre-Forward,25,VfB Stuttgart,Bundesliga,32,13,4,17
2007,Cristiano Ronaldo,Centre-Forward,22,Man Utd,Premier League,34,31,7,38
2007,Dani Güiza,Centre-Forward,26,RCD Mallorca,LaLiga,37,27,7,34
2007,Luca Toni,Centre-Forward,30,Bayern Munich,Bundesliga,31,24,7,31
2007,Alessandro Del Piero,Second Striker,32,Juventus,Serie A,37,21,8,29
2007,Karim Benzema,Centre-Forward,19,Olympique Lyon,Ligue 1,36,20,9,29
2007,Emmanuel Adebayor,Centre-Forward,23,Arsenal,Premier League,36,24,4,28
2007,Fernando Torres,Centre-Forward,23,Liverpool,Premier League,33,24,4,28
2007,Sergio Agüero,Centre-Forward,19,Atlético Madrid,LaLiga,37,19,8,27
2007,Zlatan Ibrahimović,Centre-Forward,25,Inter,Serie A,26,17,10,27
2007,Cesc Fàbregas,Central Midfield,20,Arsenal,Premier League,32,7,20,27
2007,Luís Fabiano,Centre-Forward,26,Sevilla FC,LaLiga,30,24,2,26
2007,Roque Santa Cruz,Centre-Forward,25,Blackburn,Championship,37,19,7,26
2007,Kaká,Attacking Midfield,25,AC Milan,Serie A,30,15,11,26
2007,Dimitar Berbatov,Centre-Forward,26,Tottenham,Premier League,36,15,11,26
2007,Lisandro López,Centre-Forward,24,FC Porto,Liga Portugal,27,24,1,25
2007,David Trézéguet,Centre-Forward,29,Juventus,Serie A,36,20,5,25
2007,Antonio Di Natale,Centre-Forward,29,Udinese,Serie A,36,17,8,25
2007,Wayne Rooney,Centre-Forward,21,Man Utd,Premier League,27,12,13,25
2007,Raúl,Second Striker,30,Real Madrid,LaLiga,37,18,6,24
2007,David Villa,Centre-Forward,25,Valencia,LaLiga,28,18,6,24
2007,Diego,Attacking Midfield,22,Werder Bremen,Bundesliga,30,13,11,24
2007,Lionel Messi,Right Winger,20,Barcelona,LaLiga,28,10,14,24
2007,Ashley Young,Left-Back,21,Aston Villa,Premier League,37,8,16,24
2007,Marco Borriello,Centre-Forward,25,Genoa,Serie A,35,19,4,23
2007,Mario Gómez,Centre-Forward,21,VfB Stuttgart,Bundesliga,25,19,4,23
2008,Diego Forlán,Centre-Forward,29,Atlético Madrid,LaLiga,33,32,10,42
2008,Edin Dzeko,Centre-Forward,22,VfL Wolfsburg,Bundesliga,32,26,10,36
2008,Lionel Messi,Right Winger,21,Barcelona,LaLiga,31,23,13,36
2008,Grafite,Centre-Forward,29,VfL Wolfsburg,Bundesliga,25,28,7,35
2008,Samuel Eto'o,Centre-Forward,27,Barcelona,LaLiga,36,30,4,34
2008,David Villa,Centre-Forward,26,Valencia,LaLiga,33,28,6,34
2008,Gonzalo Higuaín,Centre-Forward,20,Real Madrid,LaLiga,34,22,12,34
2008,Zlatan Ibrahimović,Centre-Forward,26,Inter,Serie A,35,25,7,32
2008,Mario Gómez,Centre-Forward,22,VfB Stuttgart,Bundesliga,32,24,8,32
2008,Diego Milito,Centre-Forward,29,Genoa,Serie A,31,24,6,30
2008,Sergio Agüero,Centre-Forward,20,Atlético Madrid,LaLiga,37,17,12,29
2008,Xavi,Central Midfield,28,Barcelona,LaLiga,35,6,23,29
2008,André-Pierre Gignac,Centre-Forward,22,Toulouse,Ligue 1,38,24,4,28
2008,Juan Mata,Attacking Midfield,20,Valencia,LaLiga,37,11,17,28
2008,Steven Gerrard,Central Midfield,28,Liverpool,Premier League,31,16,11,27
2008,Michel Bastos,Left Midfield,24,LOSC Lille,Ligue 1,37,14,13,27
2008,Zvjezdan Misimovic,Attacking Midfield,26,VfL Wolfsburg,Bundesliga,33,7,20,27
2008,Marco Di Vaio,Centre-Forward,31,Bologna,Serie A,38,24,2,26
2008,Patrick Helmes,Centre-Forward,24,B. Leverkusen,Bundesliga,34,21,5,26
2008,Thierry Henry,Centre-Forward,30,Barcelona,LaLiga,29,19,7,26
2008,Raúl,Second Striker,31,Real Madrid,LaLiga,37,18,8,26
2008,Nenê,Centre-Forward,24,Nacional,Liga Sabseg,28,20,5,25
2008,Alberto Gilardino,Centre-Forward,25,Fiorentina,Serie A,35,19,6,25
2008,Nicolas Anelka,Centre-Forward,29,Chelsea,Premier League,37,19,6,25
2008,Cristiano Ronaldo,Centre-Forward,23,Man Utd,Premier League,33,18,7,25
2008,Frédéric Kanouté,Centre-Forward,30,Sevilla FC,LaLiga,34,18,7,25
2008,Vedad Ibisevic,Centre-Forward,23,TSG Hoffenheim,Bundesliga,17,18,7,25
2008,Kaká,Attacking Midfield,26,AC Milan,Serie A,31,16,9,25
2008,Antonio Cassano,Second Striker,25,Sampdoria,Serie B,35,12,13,25
2008,Álvaro Negredo,Centre-Forward,22,UD Almería,LaLiga,34,19,5,24
2008,Guillaume Hoarau,Centre-Forward,24,Paris SG,Ligue 1,33,17,6,23
2008,Fabrizio Miccoli,Centre-Forward,29,US Palermo,Serie B,30,14,9,23
2008,Yoann Gourcuff,Attacking Midfield,21,G. Bordeaux,Ligue 2,37,12,11,23
2008,Liedson,Centre-Forward,30,Sporting CP,Liga Portugal,26,17,5,22
2008,Alessandro Del Piero,Second Striker,33,Juventus,Serie A,31,13,9,22
2008,Frank Lampard,Central Midfield,30,Chelsea,Premier League,37,12,10,22
2008,Karim Benzema,Centre-Forward,20,Olympique Lyon,Ligue 1,36,17,4,21
2008,Alexandre Pato,Centre-Forward,18,AC Milan,Serie A,36,15,6,21
2008,Demba Ba,Centre-Forward,23,TSG Hoffenheim,Bundesliga,33,14,7,21
2008,Luca Toni,Centre-Forward,31,Bayern Munich,Bundesliga,25,14,7,21
2008,Kevin Kuranyi,Centre-Forward,26,FC Schalke 04,2. Bundesliga,33,13,8,21
2008,Dirk Kuyt,Right Winger,27,Liverpool,Premier League,38,12,9,21
2008,Stefan Kießling,Centre-Forward,24,B. Leverkusen,Bundesliga,34,12,9,21
2008,Alex Frei,Centre-Forward,28,Bor. Dortmund,Bundesliga,29,12,9,21
2008,Kévin Gameiro,Centre-Forward,21,FC Lorient,Ligue 1,37,11,10,21
2008,Robin van Persie,Centre-Forward,24,Arsenal,Premier League,28,11,10,21
2008,Gabriel Agbonlahor,Centre-Forward,21,Aston Villa,Premier League,36,11,10,21
2008,Lisandro López,Centre-Forward,25,FC Porto,Liga Portugal,28,10,11,21
2008,Óscar Cardozo,Centre-Forward,25,Benfica,Liga Portugal,26,17,3,20
2008,Mauro Zárate,Centre-Forward,21,Lazio,Serie A,36,13,7,20
2009,Lionel Messi,Right Winger,22,Barcelona,LaLiga,35,34,11,45
2009,Didier Drogba,Centre-Forward,31,Chelsea,Premier League,32,29,13,42
2009,Frank Lampard,Central Midfield,31,Chelsea,Premier League,36,22,16,38
2009,Antonio Di Natale,Centre-Forward,31,Udinese,Serie A,35,29,6,35
2009,Cristiano Ronaldo,Centre-Forward,24,Real Madrid,LaLiga,29,26,9,35
2009,Gonzalo Higuaín,Centre-Forward,21,Real Madrid,LaLiga,32,27,7,34
2009,Radamel Falcao,Centre-Forward,23,FC Porto,Liga Portugal,28,25,7,32
2009,Óscar Cardozo,Centre-Forward,26,Benfica,Liga Portugal,29,26,5,31
2009,Wayne Rooney,Centre-Forward,23,Man Utd,Premier League,32,26,5,31
2009,Edin Dzeko,Centre-Forward,23,VfL Wolfsburg,Bundesliga,34,22,9,31
2009,Carlos Tevez,Second Striker,25,Man City,Premier League,35,23,7,30
2009,Cesc Fàbregas,Central Midfield,22,Arsenal,Premier League,27,15,15,30
2009,Ronaldinho,Left Winger,29,AC Milan,Serie A,36,12,18,30
2009,Darren Bent,Centre-Forward,25,Sunderland,Championship,38,24,4,28
2009,Stefan Kießling,Centre-Forward,25,B. Leverkusen,Bundesliga,33,21,7,28
2009,Diego Milito,Centre-Forward,30,Inter,Serie A,35,22,5,27
2009,Fabrizio Miccoli,Centre-Forward,30,US Palermo,Serie B,35,19,8,27
2009,Kevin Kuranyi,Centre-Forward,27,FC Schalke 04,2. Bundesliga,33,18,8,26
2009,Mamadou Niang,Centre-Forward,29,Marseille,Ligue 1,32,18,7,25
2009,Diego Forlán,Centre-Forward,30,Atlético Madrid,LaLiga,33,18,7,25
2009,Kévin Gameiro,Centre-Forward,22,FC Lorient,Ligue 1,35,17,8,25
2009,Zlatan Ibrahimović,Centre-Forward,27,Barcelona,LaLiga,29,16,9,25
2009,Zvjezdan Misimovic,Attacking Midfield,27,VfL Wolfsburg,Bundesliga,31,10,15,25
2009,Mesut Özil,Attacking Midfield,20,Werder Bremen,Bundesliga,31,9,16,25
2009,Lucas Barrios,Centre-Forward,24,Bor. Dortmund,Bundesliga,33,19,5,24
2009,Cristiano Ronaldo,Centre-Forward,25,Real Madrid,LaLiga,34,40,13,53
2009,Lionel Messi,Right Winger,23,Barcelona,LaLiga,33,31,21,52
2009,Hulk,Centre-Forward,23,FC Porto,Liga Portugal,26,23,16,39
2009,Antonio Di Natale,Centre-Forward,32,Udinese Calcio,Serie A,36,28,6,34
2009,Mario Gómez,Centre-Forward,24,Bayern Munich,Bundesliga,32,28,5,33
2009,Edinson Cavani,Centre-Forward,23,SSC Napoli,Serie A,35,26,5,31
2009,Moussa Sow,Centre-Forward,24,LOSC Lille,Ligue 1,36,25,6,31
2009,Samuel Eto'o,Centre-Forward,29,Inter,Serie A,35,21,10,31
2009,David Villa,Centre-Forward,28,Barcelona,LaLiga,34,18,11,29
2009,Nani,Left Winger,23,Man Utd,Premier League,33,9,19,28
2009,Kévin Gameiro,Centre-Forward,23,FC Lorient,Ligue 1,36,22,5,27
2009,Álvaro Negredo,Centre-Forward,24,Sevilla FC,LaLiga,38,20,7,27
2009,Nenê,Attacking Midfield,28,Paris SG,Ligue 1,35,14,13,27
2009,Carlos Tevez,Second Striker,26,Man City,Premier League,31,20,6,26
2009,Gervinho,Left Winger,23,LOSC Lille,Ligue 1,35,15,11,26
2009,Zlatan Ibrahimović,Centre-Forward,28,AC Milan,Serie A,29,14,12,26
2009,Didier Drogba,Centre-Forward,32,Chelsea,Premier League,36,11,15,26
2009,Giuseppe Rossi,Centre-Forward,23,Villarreal,LaLiga,36,18,7,25
2009,Robin van Persie,Centre-Forward,26,Arsenal,Premier League,25,18,7,25
2009,Francesco Totti,Second Striker,33,AS Roma,Serie A,32,15,10,25
2009,Thomas Müller,Second Striker,20,Bayern Munich,Bundesliga,34,12,13,25
2009,Mesut Özil,Attacking Midfield,21,Real Madrid,LaLiga,36,6,19,25
2009,Dimitar Berbatov,Centre-Forward,29,Man Utd,Premier League,32,20,4,24
2009,Sergio Agüero,Centre-Forward,22,Atlético Madrid,LaLiga,32,20,4,24
2009,Fernando Llorente,Centre-Forward,25,Athletic,LaLiga,38,18,6,24
2009,Peter Odemwingie,Right Winger,28,West Brom,Championship,32,15,9,24
2009,Franck Ribéry,Left Winger,27,Bayern Munich,Bundesliga,25,7,17,24
2009,Papiss Cissé,Centre-Forward,25,SC Freiburg,Bundesliga,32,22,1,23
2009,Lisandro López,Centre-Forward,27,Olympique Lyon,Ligue 1,27,17,6,23
2009,Milivoje Novakovic,Centre-Forward,31,1.FC Köln,Bundesliga,28,17,6,23
2009,Marco Di Vaio,Centre-Forward,33,Bologna,Serie A,38,19,3,22
2009,Youssef El Arabi,Centre-Forward,23,SM Caen,Ligue 2,38,17,5,22
2009,Lucas Barrios,Centre-Forward,25,Bor. Dortmund,Bundesliga,32,16,6,22
2009,Pedro,Right Winger,22,Barcelona,LaLiga,33,13,9,22
2009,Rafael van der Vaart,Attacking Midfield,27,Tottenham,Premier League,28,13,9,22
2009,Alexis Sánchez,Centre-Forward,21,Udinese Calcio,Serie A,31,12,10,22
2009,Arjen Robben,Right Winger,26,Bayern Munich,Bundesliga,14,12,10,22
2009,Wayne Rooney,Centre-Forward,24,Man Utd,Premier League,28,11,11,22
2009,Ángel Di María,Right Winger,22,Real Madrid,LaLiga,35,6,16,22
2009,Alessandro Matri,Centre-Forward,25,Cagliari Calcio,Serie A,38,20,1,21
2009,Roberto Soldado,Centre-Forward,25,Valencia,LaLiga,34,18,3,21
2009,Karim Benzema,Centre-Forward,22,Real Madrid,LaLiga,33,15,6,21
2009,Didier Ya Konan,Centre-Forward,26,Hannover 96,2. Bundesliga,28,14,7,21
2009,Andy Carroll,Centre-Forward,21,Liverpool,Premier League,26,13,8,21
2009,Dirk Kuyt,Right Winger,29,Liverpool,Premier League,33,13,8,21
2009,Juan Mata,Attacking Midfield,22,Valencia,LaLiga,33,8,13,21
2009,Xabi Prieto,Central Midfield,26,Real Sociedad,LaLiga,37,7,14,21
2009,Mario Götze,Attacking Midfield,18,Bor. Dortmund,Bundesliga,33,6,15,21
2009,Morgan Amalfitano,Right Midfield,25,FC Lorient,Ligue 1,38,5,16,21
2009,Marvin Martin,Attacking Midfield,22,FC Sochaux,Championnat National,37,3,18,21
2010,Lionel Messi,Right Winger,24,Barcelona,LaLiga,37,50,19,69
2010,Cristiano Ronaldo,Centre-Forward,26,Real Madrid,LaLiga,38,46,12,58
2010,Robin van Persie,Centre-Forward,27,Arsenal,Premier League,38,30,13,43
2010,Klaas-Jan Huntelaar,Centre-Forward,27,FC Schalke 04,2. Bundesliga,32,29,11,40
2010,Eden Hazard,Left Winger,20,LOSC Lille,Ligue 1,38,20,18,38
2010,Zlatan Ibrahimović,Centre-Forward,29,AC Milan,Serie A,32,28,8,36
2010,Wayne Rooney,Centre-Forward,25,Man Utd,Premier League,34,27,7,34
2010,Nenê,Attacking Midfield,29,Paris SG,Ligue 1,35,21,13,34
2010,Sergio Agüero,Centre-Forward,23,Man City,Premier League,34,23,10,33
2010,Olivier Giroud,Centre-Forward,24,Montpellier,Ligue 1,36,21,12,33
2010,Franck Ribéry,Left Winger,28,Bayern Munich,Bundesliga,32,12,21,33
2010,Robert Lewandowski,Centre-Forward,22,Bor. Dortmund,Bundesliga,34,22,10,32
2010,Karim Benzema,Centre-Forward,23,Real Madrid,LaLiga,34,21,11,32
2010,Antonio Di Natale,Centre-Forward,33,Udinese Calcio,Serie A,36,23,8,31
2010,Gonzalo Higuaín,Centre-Forward,23,Real Madrid,LaLiga,35,22,9,31
2010,Marco Reus,Attacking Midfield,22,Bor. M'gladbach,Bundesliga,32,18,12,30
2010,Mario Gómez,Centre-Forward,25,Bayern Munich,Bundesliga,33,26,3,29
2010,Fabrizio Miccoli,Centre-Forward,32,US Palermo,Serie B,28,16,13,29
2010,Radamel Falcao,Centre-Forward,25,Atlético Madrid,LaLiga,35,24,4,28
2010,Claudio Pizarro,Centre-Forward,32,Werder Bremen,Bundesliga,29,18,10,28
2010,Emmanuel Adebayor,Centre-Forward,27,Tottenham,Premier League,33,17,11,28
2010,Sebastian Giovinco,Second Striker,24,Parma,Serie B,36,15,13,28
2010,Diego Milito,Centre-Forward,32,Inter,Serie A,33,24,3,27
2010,Papiss Cissé,Centre-Forward,26,Newcastle,Premier League,31,22,5,27
2010,Pierre-Emerick Aubameyang,Centre-Forward,22,Saint-Étienne,Ligue 2,36,16,11,27
2010,Hulk,Centre-Forward,24,FC Porto,Liga Portugal,26,16,11,27
2010,Lima,Centre-Forward,28,SC Braga,Liga Portugal,30,20,6,26
2010,Lukas Podolski,Second Striker,26,1.FC Köln,Bundesliga,29,18,8,26
2010,Óscar Cardozo,Centre-Forward,28,Benfica,Liga Portugal,29,20,5,25
2010,Rodrigo Palacio,Centre-Forward,29,Genoa,Serie A,32,19,6,25
2010,Martin Harnik,Right Winger,24,VfB Stuttgart,Bundesliga,34,17,8,25
2010,Shinji Kagawa,Attacking Midfield,22,Bor. Dortmund,Bundesliga,31,13,12,25
2010,Edinson Cavani,Centre-Forward,24,SSC Napoli,Serie A,35,23,1,24
2010,Clint Dempsey,Second Striker,28,Fulham,Premier League,37,17,7,24
2010,Gareth Bale,Right Winger,21,Tottenham,Premier League,36,10,14,24
2010,Jérémy Ménez,Centre-Forward,24,Paris SG,Ligue 1,33,7,17,24
2010,David Silva,Attacking Midfield,25,Man City,Premier League,36,6,17,23
2010,Mesut Özil,Attacking Midfield,22,Real Madrid,LaLiga,35,4,19,23
2010,James Rodríguez,Attacking Midfield,19,FC Porto,Liga Portugal,26,13,9,22
2010,Mario Mandzukic,Centre-Forward,25,VfL Wolfsburg,Bundesliga,32,12,10,22
2010,Julien Féret,Attacking Midfield,28,Stade Rennais,Ligue 1,35,8,14,22
2010,Rubén Castro,Centre-Forward,30,Real Betis,LaLiga,34,16,5,21
2010,Raúl,Second Striker,34,FC Schalke 04,2. Bundesliga,32,15,6,21
2010,Mirko Vucinic,Centre-Forward,27,Juventus,Serie A,32,9,12,21
2010,Juan Arango,Left Midfield,31,Bor. M'gladbach,Bundesliga,34,6,15,21
2010,Ángel Di María,Right Winger,23,Real Madrid,LaLiga,23,5,16,21
2010,Roberto Soldado,Centre-Forward,26,Valencia,LaLiga,32,17,3,20
2010,Demba Ba,Centre-Forward,26,Newcastle,Premier League,34,16,4,20
2010,Stefan Kießling,Centre-Forward,27,B. Leverkusen,Bundesliga,34,16,4,20
2010,Vedad Ibisevic,Centre-Forward,26,VfB Stuttgart,Bundesliga,25,13,7,20
2011,Lionel Messi,Right Winger,25,Barcelona,LaLiga,32,46,13,59
2011,Cristiano Ronaldo,Centre-Forward,27,Real Madrid,LaLiga,34,34,11,45
2011,Robin van Persie,Centre-Forward,28,Man Utd,Premier League,38,26,15,41
2011,Zlatan Ibrahimović,Centre-Forward,30,Paris SG,Ligue 1,34,30,10,40
2011,Stefan Kießling,Centre-Forward,28,B. Leverkusen,Bundesliga,34,25,10,35
2011,Luis Suárez,Centre-Forward,25,Liverpool,Premier League,33,23,11,34
2011,Edinson Cavani,Centre-Forward,25,SSC Napoli,Serie A,34,29,3,32
2011,Robert Lewandowski,Centre-Forward,23,Bor. Dortmund,Bundesliga,31,24,7,31
2011,Pierre-Emerick Aubameyang,Centre-Forward,23,Saint-Étienne,Ligue 2,37,19,12,31
2011,Dimitri Payet,Attacking Midfield,25,LOSC Lille,Ligue 1,38,12,18,30
2011,Radamel Falcao,Centre-Forward,26,Atlético Madrid,LaLiga,34,28,1,29
2011,Álvaro Negredo,Centre-Forward,26,Sevilla FC,LaLiga,36,25,4,29
2011,Gareth Bale,Right Winger,22,Tottenham,Premier League,33,21,8,29
2011,Jackson Martínez,Centre-Forward,25,FC Porto,Liga Portugal,30,26,2,28
2011,Roberto Soldado,Centre-Forward,27,Valencia,LaLiga,35,24,4,28
2011,Juan Mata,Attacking Midfield,24,Chelsea,Premier League,35,12,16,28
2011,Marek Hamsik,Central Midfield,24,SSC Napoli,Serie A,38,11,17,28
2011,Antonio Di Natale,Centre-Forward,34,Udinese Calcio,Serie A,33,23,4,27
2011,Lima,Centre-Forward,29,Benfica,Liga Portugal,29,20,6,26
2011,Rubén Castro,Centre-Forward,31,Real Betis,LaLiga,34,18,8,26
2011,Theo Walcott,Right Winger,23,Arsenal,Premier League,32,14,12,26
2011,Thomas Müller,Second Striker,22,Bayern Munich,Bundesliga,28,13,13,26
2011,Francesco Totti,Second Striker,35,AS Roma,Serie A,34,12,14,26
2011,Marco Reus,Attacking Midfield,23,Bor. Dortmund,Bundesliga,32,14,11,25
2011,Carlos Vela,Right Winger,23,Real Sociedad,LaLiga,35,14,11,25
2012,Lionel Messi,Right Winger,25,Barcelona,LaLiga,32,46,13,59
2012,Cristiano Ronaldo,Centre-Forward,27,Real Madrid,LaLiga,34,34,11,45
2012,Robin van Persie,Centre-Forward,28,Man Utd,Premier League,38,26,15,41
2012,Zlatan Ibrahimović,Centre-Forward,30,Paris SG,Ligue 1,34,30,10,40
2012,Stefan Kießling,Centre-Forward,28,B. Leverkusen,Bundesliga,34,25,10,35
2012,Luis Suárez,Centre-Forward,25,Liverpool,Premier League,33,23,11,34
2012,Edinson Cavani,Centre-Forward,25,SSC Napoli,Serie A,34,29,3,32
2012,Robert Lewandowski,Centre-Forward,23,Bor. Dortmund,Bundesliga,31,24,7,31
2012,Pierre-Emerick Aubameyang,Centre-Forward,23,Saint-Étienne,Ligue 2,37,19,12,31
2012,Dimitri Payet,Attacking Midfield,25,LOSC Lille,Ligue 1,38,12,18,30
2012,Radamel Falcao,Centre-Forward,26,Atlético Madrid,LaLiga,34,28,1,29
2012,Álvaro Negredo,Centre-Forward,26,Sevilla FC,LaLiga,36,25,4,29
2012,Gareth Bale,Right Winger,22,Tottenham,Premier League,33,21,8,29
2012,Jackson Martínez,Centre-Forward,25,FC Porto,Liga Portugal,30,26,2,28
2012,Roberto Soldado,Centre-Forward,27,Valencia,LaLiga,35,24,4,28
2012,Juan Mata,Attacking Midfield,24,Chelsea,Premier League,35,12,16,28
2012,Marek Hamsik,Central Midfield,24,SSC Napoli,Serie A,38,11,17,28
2012,Antonio Di Natale,Centre-Forward,34,Udinese Calcio,Serie A,33,23,4,27
2012,Lima,Centre-Forward,29,Benfica,Liga Portugal,29,20,6,26
2012,Rubén Castro,Centre-Forward,31,Real Betis,LaLiga,34,18,8,26
2012,Theo Walcott,Right Winger,23,Arsenal,Premier League,32,14,12,26
2012,Thomas Müller,Second Striker,22,Bayern Munich,Bundesliga,28,13,13,26
2012,Francesco Totti,Second Striker,35,AS Roma,Serie A,34,12,14,26
2012,Marco Reus,Attacking Midfield,23,Bor. Dortmund,Bundesliga,32,14,11,25
2012,Carlos Vela,Right Winger,23,Real Sociedad,LaLiga,35,14,11,25
2012,Franck Ribéry,Left Winger,29,Bayern Munich,Bundesliga,27,10,15,25
2012,Mesut Özil,Attacking Midfield,23,Real Madrid,LaLiga,32,9,16,25
2012,Romelu Lukaku,Centre-Forward,19,West Brom,Championship,35,17,7,24
2012,Jérémie Aliadière,Centre-Forward,29,FC Lorient,Ligue 1,31,15,9,24
2012,Santi Cazorla,Central Midfield,27,Arsenal,Premier League,38,12,12,24
2012,Karim Benzema,Centre-Forward,24,Real Madrid,LaLiga,30,11,13,24
2012,Jakub Blaszczykowski,Right Winger,26,Bor. Dortmund,Bundesliga,27,11,13,24
2012,Christian Benteke,Centre-Forward,21,Aston Villa,Premier League,34,19,4,23
2012,Carlos Tevez,Second Striker,28,Man City,Premier League,34,11,12,23
2012,Cesc Fàbregas,Central Midfield,25,Barcelona,LaLiga,32,11,12,23
2012,Eden Hazard,Left Winger,21,Chelsea,Premier League,34,9,14,23
2012,Darío Cvitanich,Centre-Forward,28,OGC Nice,Ligue 1,29,19,3,22
2012,Rickie Lambert,Centre-Forward,30,Southampton,Championship,38,15,7,22
2012,Wayne Rooney,Centre-Forward,26,Man Utd,Premier League,27,12,10,22
2012,Mario Götze,Attacking Midfield,20,Bor. Dortmund,Bundesliga,28,10,12,22
2012,Michu,Second Striker,26,Swansea,Championship,35,18,3,21
2012,Stephan El Shaarawy,Left Winger,19,AC Milan,Serie A,37,16,5,21
2012,Gonzalo Higuaín,Centre-Forward,24,Real Madrid,LaLiga,28,16,5,21
2012,Lukas Podolski,Second Striker,27,Arsenal,Premier League,33,11,10,21
2012,Diego Costa,Centre-Forward,23,Atlético Madrid,LaLiga,31,10,11,21
2012,Piti,Attacking Midfield,31,Rayo Vallecano,LaLiga,35,18,2,20
2012,Óscar Cardozo,Centre-Forward,29,Benfica,Liga Portugal,25,17,3,20
2012,Bafétimbi Gomis,Centre-Forward,26,Olympique Lyon,Ligue 1,37,16,4,20
2012,Wissam Ben Yedder,Centre-Forward,21,Toulouse,Ligue 1,34,15,5,20
2012,Erik Lamela,Right Winger,20,AS Roma,Serie A,33,15,5,20
2013,Luis Suárez,Centre-Forward,26,Liverpool,Premier League,33,31,17,48
2013,Cristiano Ronaldo,Centre-Forward,28,Real Madrid,LaLiga,30,31,11,42
2013,Zlatan Ibrahimović,Centre-Forward,31,Paris SG,Ligue 1,33,26,15,41
2013,Lionel Messi,Right Winger,26,Barcelona,LaLiga,31,28,11,39
2013,Daniel Sturridge,Centre-Forward,23,Liverpool,Premier League,29,22,9,31
2013,Luca Toni,Centre-Forward,36,Hellas Verona,Serie A,34,20,11,31
2013,Alexis Sánchez,Centre-Forward,24,Barcelona,LaLiga,34,19,12,31
2013,Diego Costa,Centre-Forward,24,Atlético Madrid,LaLiga,35,27,3,30
2013,Robert Lewandowski,Centre-Forward,24,Bor. Dortmund,Bundesliga,33,20,10,30
2013,Marco Reus,Attacking Midfield,24,Bor. Dortmund,Bundesliga,30,16,14,30
2013,Yaya Touré,Central Midfield,30,Man City,Premier League,35,20,9,29
2013,Wayne Rooney,Centre-Forward,27,Man Utd,Premier League,29,17,12,29
2013,Roberto Firmino,Centre-Forward,21,TSG Hoffenheim,Bundesliga,33,16,12,28
2013,Carlos Vela,Right Winger,24,Real Sociedad,LaLiga,37,16,12,28
2013,Gareth Bale,Right Winger,23,Real Madrid,LaLiga,27,15,13,28
2013,Steven Gerrard,Central Midfield,33,Liverpool,Premier League,34,13,15,28
2013,Karim Benzema,Centre-Forward,25,Real Madrid,LaLiga,35,17,10,27
2013,Sergio Agüero,Centre-Forward,25,Man City,Premier League,23,17,10,27
2013,Carlos Tevez,Second Striker,29,Juventus,Serie A,34,19,7,26
2013,Ciro Immobile,Centre-Forward,23,Torino,Serie A,33,22,3,25
2013,Olivier Giroud,Centre-Forward,26,Arsenal,Premier League,36,16,9,25
2013,Aritz Aduriz,Centre-Forward,32,Athletic,LaLiga,31,16,9,25
2013,Pedro,Right Winger,25,Barcelona,LaLiga,37,15,10,25
2013,Mario Mandzukic,Centre-Forward,27,Bayern Munich,Bundesliga,30,18,6,24
2013,Rodrigo Palacio,Centre-Forward,31,Inter,Serie A,37,17,7,24
2013,Gonzalo Higuaín,Centre-Forward,25,SSC Napoli,Serie A,32,17,7,24
2013,Vincent Aboubakar,Centre-Forward,21,FC Lorient,Ligue 1,35,16,8,24
2013,Edin Dzeko,Centre-Forward,27,Man City,Premier League,31,16,8,24
2013,Derley,Centre-Forward,25,Marítimo,Liga Sabseg,30,16,8,24
2013,Thomas Müller,Second Striker,23,Bayern Munich,Bundesliga,31,13,11,24
2013,Rickie Lambert,Centre-Forward,31,Southampton,Championship,37,13,11,24
2013,Alessio Cerci,Right Winger,25,Torino,Serie A,37,13,11,24
2013,Ivan Rakitic,Central Midfield,25,Sevilla FC,LaLiga,34,12,12,24
2013,Jackson Martínez,Centre-Forward,26,FC Porto,Liga Portugal,30,20,3,23
2013,Romelu Lukaku,Centre-Forward,20,Chelsea,Premier League,33,15,8,23
2013,Eden Hazard,Left Winger,22,Chelsea,Premier League,35,14,9,23
2013,Carlos Bacca,Centre-Forward,26,Sevilla FC,LaLiga,35,14,9,23
2013,Max Kruse,Second Striker,25,Bor. M'gladbach,Bundesliga,34,12,11,23
2013,Domenico Berardi,Right Winger,18,Sassuolo,Serie A,29,16,6,22
2013,Adrián Ramos,Centre-Forward,27,Hertha BSC,2. Bundesliga,32,16,6,22
2013,José Callejón,Right Winger,26,SSC Napoli,Serie A,37,15,7,22
2013,Raffael,Second Striker,28,Bor. M'gladbach,Bundesliga,34,14,8,22
2013,Franck Ribéry,Left Winger,30,Bayern Munich,Bundesliga,22,10,12,22
2013,James Rodríguez,Attacking Midfield,21,Monaco,Ligue 1,34,9,13,22
2013,Cesc Fàbregas,Central Midfield,26,Barcelona,LaLiga,36,8,14,22
2013,Ángel Di María,Right Winger,25,Real Madrid,LaLiga,34,4,18,22
2013,Wilfried Bony,Centre-Forward,24,Swansea,Championship,34,17,4,21
2013,Wissam Ben Yedder,Centre-Forward,22,Toulouse,Ligue 1,38,16,5,21
2013,Edinson Cavani,Centre-Forward,26,Paris SG,Ligue 1,30,16,5,21
2013,Salomon Kalou,Left Winger,27,LOSC Lille,Ligue 1,38,16,5,21
2014,Cristiano Ronaldo,Centre-Forward,29,Real Madrid,LaLiga,35,48,17,65
2014,Lionel Messi,Right Winger,27,Barcelona,LaLiga,38,43,21,64
2014,Alexandre Lacazette,Centre-Forward,23,Olympique Lyon,Ligue 1,33,27,8,35
2014,Sergio Agüero,Centre-Forward,26,Man City,Premier League,33,26,8,34
2014,Luis Suárez,Centre-Forward,27,Barcelona,LaLiga,27,16,16,32
2014,Neymar,Left Winger,22,Barcelona,LaLiga,33,22,9,31
2014,Kevin De Bruyne,Attacking Midfield,23,VfL Wolfsburg,Bundesliga,34,10,21,31
2014,Mauro Icardi,Centre-Forward,21,Inter,Serie A,36,22,8,30
2014,Dimitri Payet,Attacking Midfield,27,Marseille,Ligue 1,36,7,21,28
2014,Jackson Martínez,Centre-Forward,27,FC Porto,Liga Portugal,30,21,6,27
2014,Carlos Bacca,Centre-Forward,27,Sevilla FC,LaLiga,37,20,7,27
2014,Carlos Tevez,Second Striker,30,Juventus,Serie A,32,20,7,27
2014,Lima,Centre-Forward,31,Benfica,Liga Portugal,34,19,8,27
2014,Thomas Müller,Second Striker,24,Bayern Munich,Bundesliga,32,13,14,27
2014,Harry Kane,Centre-Forward,20,Tottenham,Premier League,34,21,5,26
2014,Jonas,Second Striker,30,Benfica,Liga Portugal,27,20,6,26
2014,Karim Benzema,Centre-Forward,26,Real Madrid,LaLiga,29,15,11,26
2014,Domenico Berardi,Right Winger,19,Sassuolo,Serie A,32,15,11,26
2014,James Rodríguez,Attacking Midfield,22,Real Madrid,LaLiga,29,13,13,26
2014,Nolito,Left Winger,27,Celta de Vigo,LaLiga,36,13,13,26
2014,Antoine Griezmann,Centre-Forward,23,Atlético Madrid,LaLiga,37,22,3,25
2014,Luca Toni,Centre-Forward,37,Hellas Verona,Serie A,38,22,3,25
2014,Zlatan Ibrahimović,Centre-Forward,32,Paris SG,Ligue 1,24,19,6,25
2014,Charlie Austin,Centre-Forward,24,QPR,Championship,35,18,7,25
2014,Gonzalo Higuaín,Centre-Forward,26,SSC Napoli,Serie A,37,18,7,25
2014,Nabil Fekir,Attacking Midfield,20,Olympique Lyon,Ligue 1,34,13,12,25
2014,Robert Lewandowski,Centre-Forward,25,Bayern Munich,Bundesliga,31,17,7,24
2014,Arjen Robben,Right Winger,30,Bayern Munich,Bundesliga,21,17,7,24
2014,Alexis Sánchez,Centre-Forward,25,Arsenal,Premier League,35,16,8,24
2014,Eden Hazard,Left Winger,23,Chelsea,Premier League,38,14,10,24
2014,André-Pierre Gignac,Centre-Forward,28,Marseille,Ligue 1,38,21,2,23
2014,Diego Costa,Centre-Forward,25,Chelsea,Premier League,26,20,3,23
2014,Pierre-Emerick Aubameyang,Centre-Forward,25,Bor. Dortmund,Bundesliga,33,16,7,23
2014,Sergio García,Centre-Forward,31,Espanyol,LaLiga2,35,14,9,23
2014,Paulo Dybala,Second Striker,20,US Palermo,Serie B,34,13,10,23
2014,David Silva,Attacking Midfield,28,Man City,Premier League,32,12,11,23
2014,Alexander Meier,Second Striker,31,E. Frankfurt,Bundesliga,26,19,3,22
2014,Gareth Bale,Right Winger,24,Real Madrid,LaLiga,31,13,9,22
2014,Antonio Candreva,Right Midfield,27,Lazio,Serie A,34,10,12,22
2014,Cesc Fàbregas,Central Midfield,27,Chelsea,Premier League,34,3,19,22
2014,Max Gradel,Left Winger,26,Saint-Étienne,Ligue 2,31,17,4,21
2014,Alberto Bueno,Second Striker,26,Rayo Vallecano,LaLiga,36,17,4,21
2014,Claudio Beauvue,Centre-Forward,26,Guingamp,Ligue 2,36,17,4,21
2014,Jonathas,Centre-Forward,25,Elche CF,LaLiga2,34,14,7,21
2014,Antonio Di Natale,Centre-Forward,36,Udinese Calcio,Serie A,33,14,7,21
2014,Karim Bellarabi,Right Winger,24,B. Leverkusen,Bundesliga,33,12,9,21
2014,Franco Vázquez,Attacking Midfield,25,US Palermo,Serie B,37,10,11,21
2014,Zlatko Junuzovic,Central Midfield,26,Werder Bremen,Bundesliga,33,6,15,21
2014,Bas Dost,Centre-Forward,25,VfL Wolfsburg,Bundesliga,21,16,4,20
2015,Luis Suárez,Centre-Forward,28,Barcelona,LaLiga,35,40,18,58
2015,Zlatan Ibrahimović,Centre-Forward,33,Paris SG,Ligue 1,31,38,13,51
2015,Cristiano Ronaldo,Centre-Forward,30,Real Madrid,LaLiga,36,35,11,46
2015,Jonas,Second Striker,31,Benfica,Liga Portugal,34,32,14,46
2015,Lionel Messi,Right Winger,28,Barcelona,LaLiga,33,26,16,42
2015,Neymar,Left Winger,23,Barcelona,LaLiga,34,24,16,40
2015,Gonzalo Higuaín,Centre-Forward,27,SSC Napoli,Serie A,35,36,2,38
2015,Robert Lewandowski,Centre-Forward,26,Bayern Munich,Bundesliga,32,30,5,35
2015,Islam Slimani,Centre-Forward,27,Sporting CP,Liga Portugal,33,27,6,33
2015,Karim Benzema,Centre-Forward,27,Real Madrid,LaLiga,27,24,8,32
2015,Jamie Vardy,Centre-Forward,28,Leicester,Championship,36,24,8,32
2015,Pierre-Emerick Aubameyang,Centre-Forward,26,Bor. Dortmund,Bundesliga,31,25,6,31
2015,Henrikh Mkhitaryan,Central Midfield,26,Bor. Dortmund,Bundesliga,31,11,20,31
2015,Gareth Bale,Right Winger,25,Real Madrid,LaLiga,23,19,11,30
2015,Antoine Griezmann,Centre-Forward,24,Atlético Madrid,LaLiga,38,22,6,28
2015,Ángel Di María,Right Winger,27,Paris SG,Ligue 1,29,10,18,28
2015,Thomas Müller,Second Striker,25,Bayern Munich,Bundesliga,31,20,7,27
2015,Riyad Mahrez,Right Winger,24,Leicester,Championship,37,17,10,27
2015,Lucas Pérez,Centre-Forward,26,Dep. La Coruña,Primera Federación - Gr. I,36,17,10,27
2015,Harry Kane,Centre-Forward,21,Tottenham,Premier League,38,25,1,26
2015,Sergio Agüero,Centre-Forward,27,Man City,Premier League,30,24,2,26
2015,Aritz Aduriz,Centre-Forward,34,Athletic,LaLiga,34,20,6,26
2015,Paulo Dybala,Second Striker,21,Juventus,Serie A,34,19,7,26
2015,Michy Batshuayi,Centre-Forward,21,Marseille,Ligue 1,36,17,9,26
2015,Konstantinos Mitroglou,Centre-Forward,27,Benfica,Liga Portugal,32,20,5,25
2016,Romelu Lukaku,Centre-Forward,22,Everton,Premier League,37,18,7,25
2016,Mesut Özil,Attacking Midfield,26,Arsenal,Premier League,35,6,19,25
2016,Alexandre Lacazette,Centre-Forward,24,Olympique Lyon,Ligue 1,34,21,3,24
2016,Edinson Cavani,Centre-Forward,28,Paris SG,Ligue 1,32,19,5,24
2016,Hatem Ben Arfa,Attacking Midfield,28,OGC Nice,Ligue 1,34,17,6,23
2016,Raffael,Second Striker,30,Bor. M'gladbach,Bundesliga,31,13,10,23
2016,Borja Bastón,Centre-Forward,22,SD Eibar,LaLiga2,36,18,4,22
2016,Wissam Ben Yedder,Centre-Forward,24,Toulouse,Ligue 1,35,17,5,22
2016,Olivier Giroud,Centre-Forward,28,Arsenal,Premier League,38,16,6,22
2016,Rubén Castro,Centre-Forward,34,Real Betis,LaLiga,38,19,2,21
2016,Odion Ighalo,Centre-Forward,26,Watford,Championship,37,16,5,21
2016,Troy Deeney,Centre-Forward,27,Watford,Championship,38,13,8,21
2016,Lorenzo Insigne,Left Winger,24,SSC Napoli,Serie A,37,12,9,21
2016,Dimitri Payet,Attacking Midfield,28,West Ham,Premier League,30,9,12,21
2016,Salvador Agra,Right Winger,23,Nacional,Liga Sabseg,34,9,12,21
2016,Dusan Tadic,Left Winger,26,Southampton,Championship,34,8,13,21
2016,Bryan Ruiz,Attacking Midfield,29,Sporting CP,Liga Portugal,34,8,13,21
2016,Christian Eriksen,Attacking Midfield,23,Tottenham,Premier League,35,6,15,21
2016,Miguel Layún,Right-Back,27,Watford,Championship,30,6,15,21
2016,Carlos Bacca,Centre-Forward,28,AC Milan,Serie A,38,18,2,20
2016,Léo Bonatini,Centre-Forward,21,Estoril Praia,Liga Portugal,33,17,3,20
2016,Chicharito,Centre-Forward,27,B. Leverkusen,Bundesliga,29,17,3,20
2016,Mauro Icardi,Centre-Forward,22,Inter,Serie A,33,16,4,20
2016,Kévin Gameiro,Centre-Forward,28,Sevilla FC,LaLiga,31,16,4,20
2016,Mohamed Salah,Right Winger,23,AS Roma,Serie A,34,14,6,20
2016,Lionel Messi,Right Winger,29,Barcelona,LaLiga,34,37,12,49
2016,Luis Suárez,Centre-Forward,29,Barcelona,LaLiga,35,28,15,43
2016,Edin Dzeko,Centre-Forward,30,AS Roma,Serie A,37,29,12,41
2016,Bas Dost,Centre-Forward,27,Sporting CP,Liga Portugal,32,34,6,40
2016,Edinson Cavani,Centre-Forward,29,Paris SG,Ligue 1,36,35,4,39
2016,Dries Mertens,Second Striker,29,SSC Napoli,Serie A,35,28,9,37
2016,Robert Lewandowski,Centre-Forward,27,Bayern Munich,Bundesliga,33,30,6,36
2016,Harry Kane,Centre-Forward,22,Tottenham,Premier League,30,29,7,36
2016,Alexis Sánchez,Centre-Forward,27,Arsenal,Premier League,38,24,11,35
2016,Pierre-Emerick Aubameyang,Centre-Forward,27,Bor. Dortmund,Bundesliga,32,31,2,33
2016,Mauro Icardi,Centre-Forward,23,Inter,Serie A,34,24,8,32
2016,Alexandre Lacazette,Centre-Forward,25,Olympique Lyon,Ligue 1,30,28,3,31
2016,Andrea Belotti,Centre-Forward,22,Torino,Serie A,35,26,5,31
2016,Romelu Lukaku,Centre-Forward,23,Everton,Premier League,37,25,6,31
2016,Cristiano Ronaldo,Centre-Forward,31,Real Madrid,LaLiga,29,25,6,31
2016,Emil Forsberg,Attacking Midfield,24,RB Leipzig,Bundesliga,30,8,22,30
2016,Timo Werner,Centre-Forward,20,RB Leipzig,Bundesliga,31,21,7,28
2016,Diego Costa,Centre-Forward,27,Chelsea,Premier League,35,20,8,28
2016,Papu Gómez,Left Winger,28,Atalanta BC,Serie A,37,16,12,28
2016,Mohamed Salah,Right Winger,24,AS Roma,Serie A,31,15,13,28
2016,Anthony Modeste,Centre-Forward,28,1.FC Köln,Bundesliga,34,25,2,27
2016,Gonzalo Higuaín,Centre-Forward,28,Juventus,Serie A,38,24,3,27
2016,Dele Alli,Attacking Midfield,20,Tottenham,Premier League,37,18,9,27
2016,José Callejón,Right Winger,29,SSC Napoli,Serie A,37,14,13,27
2016,Neymar,Left Winger,24,Barcelona,LaLiga,30,13,14,27
2016,Ciro Immobile,Centre-Forward,26,Lazio,Serie A,36,23,3,26
2016,Radamel Falcao,Centre-Forward,30,Monaco,Ligue 1,29,21,5,26
2016,Lorenzo Insigne,Left Winger,25,SSC Napoli,Serie A,37,18,8,26
2016,Kylian Mbappé,Centre-Forward,17,Monaco,Ligue 1,29,15,11,26
2016,Florian Thauvin,Right Winger,23,Marseille,Ligue 1,38,15,10,25
2016,Kevin De Bruyne,Attacking Midfield,25,Man City,Premier League,36,6,19,25
2016,Sergio Agüero,Centre-Forward,28,Man City,Premier League,31,20,4,24
2016,Antoine Griezmann,Centre-Forward,25,Atlético Madrid,LaLiga,36,16,8,24
2016,Arjen Robben,Right Winger,32,Bayern Munich,Bundesliga,26,13,11,24
2016,Christian Eriksen,Attacking Midfield,24,Tottenham,Premier League,36,8,16,24
2016,Bafétimbi Gomis,Centre-Forward,30,Marseille,Ligue 1,31,20,3,23
2016,Iago Aspas,Centre-Forward,28,Celta de Vigo,LaLiga,32,19,4,23
2016,Andrej Kramaric,Centre-Forward,25,TSG Hoffenheim,Bundesliga,34,15,8,23
2016,Tiquinho Soares,Centre-Forward,25,FC Porto,Liga Portugal,31,19,3,22
2016,Zlatan Ibrahimović,Centre-Forward,34,Man Utd,Premier League,28,17,5,22
2016,André Silva,Centre-Forward,20,FC Porto,Liga Portugal,32,16,6,22
2016,Max Kruse,Second Striker,28,Werder Bremen,Bundesliga,23,15,7,22
2016,Heung-min Son,Left Winger,23,Tottenham,Premier League,34,14,8,22
2016,Gylfi Sigurdsson,Attacking Midfield,26,Swansea,Championship,38,9,13,22
2016,Eden Hazard,Left Winger,25,Chelsea,Premier League,36,16,5,21
2016,Moussa Marega,Centre-Forward,25,Vit. Guimarães,Liga Portugal,25,13,8,21
2016,Marek Hamsik,Central Midfield,28,SSC Napoli,Serie A,38,12,9,21
2016,Roberto Firmino,Centre-Forward,24,Liverpool,Premier League,35,11,10,21
2016,Loïs Diony,Centre-Forward,23,Dijon,Championnat National,35,11,10,21
2016,Pablo Piatti,Left Winger,27,Espanyol,LaLiga2,30,10,11,21
2017,Lionel Messi,Right Winger,30,Barcelona,LaLiga,36,34,14,48
2017,Mohamed Salah,Right Winger,25,Liverpool,Premier League,36,32,11,43
2017,Jonas,Second Striker,33,Benfica,Liga Portugal,30,34,6,40
2017,Luis Suárez,Centre-Forward,30,Barcelona,LaLiga,33,25,13,38
2017,Ciro Immobile,Centre-Forward,27,Lazio,Serie A,33,29,8,37
2017,Edinson Cavani,Centre-Forward,30,Paris SG,Ligue 1,32,28,7,35
2017,Harry Kane,Centre-Forward,23,Tottenham,Premier League,37,30,3,33
2017,Florian Thauvin,Right Winger,24,Marseille,Ligue 1,35,22,11,33
2017,Raheem Sterling,Left Winger,22,Man City,Premier League,33,18,15,33
2017,Neymar,Left Winger,25,Paris SG,Ligue 1,20,19,13,32
2017,Memphis Depay,Centre-Forward,23,Olympique Lyon,Ligue 1,36,19,13,32
2017,Robert Lewandowski,Centre-Forward,28,Bayern Munich,Bundesliga,30,29,2,31
2017,Bas Dost,Centre-Forward,28,Sporting CP,Liga Portugal,30,27,4,31
2017,Cristiano Ronaldo,Centre-Forward,32,Real Madrid,LaLiga,27,26,5,31
2017,Mauro Icardi,Centre-Forward,24,Inter,Serie A,34,29,1,30
2017,Pierre-Emerick Aubameyang,Centre-Forward,28,Arsenal,Premier League,29,23,7,30
2017,Antoine Griezmann,Centre-Forward,26,Atlético Madrid,LaLiga,32,19,9,28
2017,Paulo Dybala,Second Striker,23,Juventus,Serie A,33,22,5,27
2017,Iago Aspas,Centre-Forward,29,Celta de Vigo,LaLiga,34,22,5,27
2017,Sergio Agüero,Centre-Forward,29,Man City,Premier League,25,21,6,27
2017,Moussa Marega,Centre-Forward,26,FC Porto,Liga Portugal,29,22,4,26
2017,Philippe Coutinho,Left Winger,25,Barcelona,LaLiga,32,14,12,26
2017,Nabil Fekir,Attacking Midfield,23,Olympique Lyon,Ligue 1,30,18,7,25
2017,Luis Alberto,Central Midfield,24,Lazio,Serie A,34,11,14,25
2017,Leroy Sané,Right Winger,21,Man City,Premier League,32,10,15,25
2017,Fabio Quagliarella,Centre-Forward,34,Sampdoria,Serie B,35,19,5,24
2017,Dries Mertens,Second Striker,30,SSC Napoli,Serie A,38,18,6,24
2017,Kevin De Bruyne,Attacking Midfield,26,Man City,Premier League,37,8,16,24
2017,Thomas Müller,Second Striker,27,Bayern Munich,Bundesliga,29,8,16,24
2017,Maxi Gómez,Centre-Forward,20,Celta de Vigo,LaLiga,36,18,5,23
2017,Mariano Díaz,Centre-Forward,23,Olympique Lyon,Ligue 1,34,18,5,23
2017,Radamel Falcao,Centre-Forward,31,Monaco,Ligue 1,26,18,5,23
2017,Karl Toko Ekambi,Centre-Forward,24,Angers SCO,Ligue 2,37,17,6,23
2017,Romelu Lukaku,Centre-Forward,24,Man Utd,Premier League,34,16,7,23
2017,Rodrigo,Centre-Forward,26,Valencia,LaLiga,37,16,7,23
2017,Riyad Mahrez,Right Winger,26,Leicester,Championship,36,12,11,23
2017,Alassane Plea,Centre-Forward,24,OGC Nice,Ligue 1,35,16,6,22
2017,Roberto Firmino,Centre-Forward,25,Liverpool,Premier League,37,15,7,22
2017,Rony Lopes,Right Winger,21,Monaco,Ligue 1,38,15,7,22
2017,Mark Uth,Centre-Forward,25,TSG Hoffenheim,Bundesliga,31,14,8,22
2017,Ivan Perisic,Left Midfield,28,Inter,Serie A,37,11,11,22
2017,Cristhian Stuani,Centre-Forward,30,Girona,LaLiga,33,21,0,21
2017,Jamie Vardy,Centre-Forward,30,Leicester,Championship,37,20,1,21
2017,Carlos Bacca,Centre-Forward,30,Villarreal,LaLiga,35,15,6,21
2017,Fabrício,Left Winger,27,Portimonense,Liga Portugal,29,15,6,21
2017,Timo Werner,Centre-Forward,21,RB Leipzig,Bundesliga,32,13,8,21
2017,Andrej Kramaric,Centre-Forward,26,TSG Hoffenheim,Bundesliga,34,13,8,21
2017,Christian Eriksen,Attacking Midfield,25,Tottenham,Premier League,37,10,11,21
2017,Shoya Nakajima,Attacking Midfield,22,Portimonense,Liga Portugal,29,10,11,21
2017,José Callejón,Right Winger,30,SSC Napoli,Serie A,38,10,11,21
2018,Lionel Messi,Right Winger,31,Barcelona,LaLiga,34,36,14,50
2018,Kylian Mbappé,Centre-Forward,19,Paris SG,Ligue 1,29,33,9,42
2018,Fabio Quagliarella,Centre-Forward,35,Sampdoria,Serie B,37,26,7,33
2018,Nicolas Pépé,Right Winger,23,LOSC Lille,Ligue 1,38,22,11,33
2018,Bruno Fernandes,Attacking Midfield,23,Sporting CP,Liga Portugal,33,20,13,33
2018,Mohamed Salah,Right Winger,26,Liverpool,Premier League,38,22,10,32
2018,Robert Lewandowski,Centre-Forward,29,Bayern Munich,Bundesliga,33,22,10,32
2018,Eden Hazard,Left Winger,27,Chelsea,Premier League,37,16,15,31
2018,Pizzi,Attacking Midfield,28,Benfica,Liga Portugal,34,13,18,31
2018,Duván Zapata,Centre-Forward,27,Atalanta BC,Serie A,37,23,7,30
2018,Cristiano Ronaldo,Centre-Forward,33,Juventus,Serie A,31,21,9,30
2018,Jadon Sancho,Left Winger,18,Bor. Dortmund,Bundesliga,34,12,18,30
2018,Haris Seferovic,Centre-Forward,26,Benfica,Liga Portugal,29,23,5,28
2018,Karim Benzema,Centre-Forward,30,Real Madrid,LaLiga,36,21,7,28
2018,Sergio Agüero,Centre-Forward,30,Man City,Premier League,33,21,7,28
2018,Raheem Sterling,Left Winger,23,Man City,Premier League,34,17,11,28
2018,Marco Reus,Attacking Midfield,29,Bor. Dortmund,Bundesliga,27,17,11,28
2018,Pierre-Emerick Aubameyang,Centre-Forward,29,Arsenal,Premier League,36,22,5,27
2018,Luis Suárez,Centre-Forward,31,Barcelona,LaLiga,33,19,8,27
2018,Wissam Ben Yedder,Centre-Forward,27,Sevilla FC,LaLiga,35,18,9,27
2018,Iago Aspas,Centre-Forward,30,Celta de Vigo,LaLiga,27,20,6,26
2018,Dries Mertens,Second Striker,31,SSC Napoli,Serie A,35,16,10,26
2018,Kevin Volland,Centre-Forward,25,B. Leverkusen,Bundesliga,34,14,12,26
2018,Pablo Sarabia,Right Winger,26,Sevilla FC,LaLiga,33,13,13,26
2018,Timo Werner,Centre-Forward,22,RB Leipzig,Bundesliga,30,16,9,25
2018,Sadio Mané,Left Winger,26,Liverpool,Premier League,36,22,2,24
2018,Edinson Cavani,Centre-Forward,31,Paris SG,Ligue 1,21,18,6,24
2018,Wout Weghorst,Centre-Forward,25,VfL Wolfsburg,Bundesliga,34,17,7,24
2018,Florian Thauvin,Right Winger,25,Marseille,Ligue 1,33,16,8,24
2018,João Félix,Second Striker,18,Benfica,Liga Portugal,26,15,9,24
2018,Sébastien Haller,Centre-Forward,24,E. Frankfurt,Bundesliga,29,15,9,24
2018,Callum Wilson,Centre-Forward,26,Bournemouth,Premier League,30,14,10,24
2018,Ángel Di María,Right Winger,30,Paris SG,Ligue 1,30,12,12,24
2018,Krzysztof Piatek,Centre-Forward,23,AC Milan,Serie A,37,22,1,23
2018,Luka Jović,Centre-Forward,20,E. Frankfurt,Bundesliga,32,17,6,23
2018,Neymar,Left Winger,26,Paris SG,Ligue 1,17,15,8,23
2018,Antoine Griezmann,Centre-Forward,27,Atlético Madrid,LaLiga,37,15,8,23
2018,Alexandre Lacazette,Centre-Forward,27,Arsenal,Premier League,35,13,10,23
2018,Jamie Vardy,Centre-Forward,31,Leicester,Championship,34,18,4,22
2018,Dyego Sousa,Centre-Forward,28,SC Braga,Liga Portugal,33,15,7,22
2018,Paul Pogba,Central Midfield,25,Man Utd,Premier League,35,13,9,22
2018,Leroy Sané,Right Winger,22,Man City,Premier League,31,10,12,22
2018,Harry Kane,Centre-Forward,24,Tottenham,Premier League,28,17,4,21
2018,Kai Havertz,Attacking Midfield,19,B. Leverkusen,Bundesliga,34,17,4,21
2018,Andrej Kramaric,Centre-Forward,27,TSG Hoffenheim,Bundesliga,30,17,4,21
2018,Ishak Belfodil,Centre-Forward,26,TSG Hoffenheim,Bundesliga,28,16,5,21
2018,Ciro Immobile,Centre-Forward,28,Lazio,Serie A,36,15,6,21
2018,Andy Delort,Centre-Forward,26,Montpellier,Ligue 1,36,14,7,21
2018,Raúl Jiménez,Centre-Forward,27,Wolves,Premier League,38,13,8,21
2018,Max Kruse,Second Striker,30,Werder Bremen,Bundesliga,32,11,10,21
2019,Lionel Messi,Right Winger,32,Barcelona,LaLiga,33,25,22,47
2019,Ciro Immobile,Centre-Forward,29,Lazio,Serie A,37,36,8,44
2019,Robert Lewandowski,Centre-Forward,30,Bayern Munich,Bundesliga,31,34,4,38
2019,Cristiano Ronaldo,Centre-Forward,34,Juventus,Serie A,33,31,6,37
2019,Timo Werner,Centre-Forward,23,RB Leipzig,Bundesliga,34,28,8,36
2019,Jadon Sancho,Left Winger,19,Bor. Dortmund,Bundesliga,32,17,17,34
2019,Kevin De Bruyne,Attacking Midfield,28,Man City,Premier League,35,13,20,33
2019,Pizzi,Attacking Midfield,29,Benfica,Liga Portugal,34,18,14,32
2019,Bruno Fernandes,Attacking Midfield,24,Man Utd,Premier League,31,16,14,30
2019,Karim Benzema,Centre-Forward,31,Real Madrid,LaLiga,37,21,8,29
2019,Mohamed Salah,Right Winger,27,Liverpool,Premier League,34,19,10,29
2019,Thomas Müller,Second Striker,29,Bayern Munich,Bundesliga,33,8,21,29
2019,Jamie Vardy,Centre-Forward,32,Leicester,Championship,35,23,5,28
2019,Francesco Caputo,Centre-Forward,31,Sassuolo,Serie A,36,21,7,28
2019,Sadio Mané,Left Winger,27,Liverpool,Premier League,35,18,9,27
2019,Edin Dzeko,Centre-Forward,33,AS Roma,Serie A,35,16,11,27
2019,Carlos Vinícius,Centre-Forward,24,Benfica,Liga Portugal,32,18,8,26
2019,Marcus Rashford,Left Winger,21,Man Utd,Premier League,31,17,9,26
2019,Romelu Lukaku,Centre-Forward,26,Inter,Serie A,36,23,2,25
2019,Pierre-Emerick Aubameyang,Centre-Forward,30,Arsenal,Premier League,36,22,3,25
2019,Kylian Mbappé,Centre-Forward,20,Paris SG,Ligue 1,20,18,7,25
2019,Wissam Ben Yedder,Centre-Forward,28,Monaco,Ligue 1,26,18,7,25
2019,Duván Zapata,Centre-Forward,28,Atalanta BC,Serie A,28,18,7,25
2019,Danny Ings,Centre-Forward,26,Southampton,Championship,38,22,2,24
2019,Raheem Sterling,Left Winger,24,Man City,Premier League,33,20,4,24
2019,Gerard Moreno,Centre-Forward,27,Villarreal,LaLiga,35,18,6,24
2019,Anthony Martial,Centre-Forward,23,Man Utd,Premier League,32,17,7,24
2019,Luis Suárez,Centre-Forward,32,Barcelona,LaLiga,28,16,8,24
2019,Domenico Berardi,Right Winger,24,Sassuolo,Serie A,31,14,10,24
2019,Mehdi Taremi,Centre-Forward,26,Rio Ave,Liga Portugal,30,18,5,23
2019,Raúl Jiménez,Centre-Forward,28,Wolves,Premier League,38,17,6,23
2019,Paulinho,Centre-Forward,26,SC Braga,Liga Portugal,26,16,7,23
2019,Josip Ilicic,Attacking Midfield,31,Atalanta BC,Serie A,26,15,8,23
2019,Serge Gnabry,Right Winger,23,Bayern Munich,Bundesliga,31,12,11,23
2019,Riyad Mahrez,Right Winger,28,Man City,Premier League,33,11,12,23
2019,Papu Gómez,Left Winger,31,Atalanta BC,Serie A,36,7,16,23
2019,João Pedro,Centre-Forward,27,Cagliari Calcio,Serie A,36,18,4,22
2019,Gabriel Jesus,Centre-Forward,22,Man City,Premier League,34,14,8,22
2019,Heung-min Son,Left Winger,26,Tottenham,Premier League,30,11,11,22
2019,Paulo Dybala,Second Striker,25,Juventus,Serie A,33,11,11,22
2019,Ángel Di María,Right Winger,31,Paris SG,Ligue 1,26,8,14,22
2019,Luis Alberto,Central Midfield,26,Lazio,Serie A,36,6,16,22
2019,Florian Niederlechner,Centre-Forward,28,FC Augsburg,Bundesliga,33,13,8,21
2019,Santi Cazorla,Central Midfield,34,Villarreal,LaLiga,35,11,10,21
2019,Mikel Oyarzabal,Left Winger,22,Real Sociedad,LaLiga,37,10,11,21
2019,Harry Kane,Centre-Forward,25,Tottenham,Premier League,29,18,2,20
2019,Sergio Agüero,Centre-Forward,31,Man City,Premier League,24,16,4,20
2019,Alassane Plea,Centre-Forward,26,Bor. M'gladbach,Bundesliga,27,10,10,20
2019,Thorgan Hazard,Left Winger,26,Bor. Dortmund,Bundesliga,33,7,13,20
2019,Christopher Nkunku,Second Striker,21,RB Leipzig,Bundesliga,32,5,15,20
2020,Robert Lewandowski,Centre-Forward,31,Bayern Munich,Bundesliga,29,41,7,48
2020,Lionel Messi,Right Winger,33,Barcelona,LaLiga,35,30,11,41
2020,Harry Kane,Centre-Forward,26,Tottenham,Premier League,35,23,14,37
2020,André Silva,Centre-Forward,24,E. Frankfurt,Bundesliga,32,28,8,36
2020,Erling Haaland,Centre-Forward,19,Bor. Dortmund,Bundesliga,28,27,8,35
2020,Kylian Mbappé,Centre-Forward,21,Paris SG,Ligue 1,31,27,7,34
2020,Romelu Lukaku,Centre-Forward,27,Inter,Serie A,36,24,10,34
2020,Karim Benzema,Centre-Forward,32,Real Madrid,LaLiga,34,23,9,32
2020,Memphis Depay,Centre-Forward,26,Olympique Lyon,Ligue 1,37,20,12,32
2020,Thomas Müller,Second Striker,30,Bayern Munich,Bundesliga,32,11,21,32
2020,Cristiano Ronaldo,Centre-Forward,35,Juventus,Serie A,33,29,2,31
2020,Luis Muriel,Centre-Forward,29,Atalanta BC,Serie A,36,22,9,31
2020,Mehdi Taremi,Centre-Forward,27,FC Porto,Liga Portugal,34,16,15,31
2020,Gerard Moreno,Centre-Forward,28,Villarreal,LaLiga,33,23,7,30
2020,Haris Seferovic,Centre-Forward,28,Benfica,Liga Portugal,31,22,7,29
2020,Wout Weghorst,Centre-Forward,27,VfL Wolfsburg,Bundesliga,34,20,9,29
2020,Bruno Fernandes,Attacking Midfield,25,Man Utd,Premier League,37,18,11,29
2020,Wissam Ben Yedder,Centre-Forward,29,Monaco,Ligue 1,37,20,8,28
2020,Pedro Gonçalves,Right Winger,22,Sporting CP,Liga Portugal,32,23,4,27
2020,Mohamed Salah,Right Winger,28,Liverpool,Premier League,37,22,5,27
2020,Ciro Immobile,Centre-Forward,30,Lazio,Serie A,35,20,7,27
2020,Lautaro Martínez,Centre-Forward,22,Inter,Serie A,38,17,10,27
2020,Heung-min Son,Left Winger,27,Tottenham,Premier League,37,17,10,27
2020,Iago Aspas,Centre-Forward,32,Celta de Vigo,LaLiga,33,14,13,27
2020,Andrej Kramaric,Centre-Forward,29,TSG Hoffenheim,Bundesliga,28,20,6,26
2020,Lorenzo Insigne,Left Winger,29,SSC Napoli,Serie A,35,19,7,26
2020,Domenico Berardi,Right Winger,25,Sassuolo,Serie A,30,17,8,25
2020,Patrick Bamford,Centre-Forward,26,Leeds,Championship,38,17,8,25
2020,Duván Zapata,Centre-Forward,29,Atalanta BC,Serie A,37,15,10,25
2020,Andy Delort,Centre-Forward,28,Montpellier,Ligue 1,30,15,10,25
2020,Luis Suárez,Centre-Forward,33,Atlético Madrid,LaLiga,32,21,3,24
2020,Gaëtan Laborde,Centre-Forward,26,Montpellier,Ligue 1,38,16,8,24
2020,Kevin Volland,Centre-Forward,27,Monaco,Ligue 1,35,16,8,24
2020,Jamie Vardy,Centre-Forward,33,Leicester,Championship,34,15,9,24
2020,Lars Stindl,Attacking Midfield,31,Bor. M'gladbach,Bundesliga,30,14,10,24
2020,Henrikh Mkhitaryan,Central Midfield,31,AS Roma,Serie A,34,13,11,24
2020,Dušan Vlahović,Centre-Forward,20,Fiorentina,Serie A,37,21,2,23
2020,Simy,Centre-Forward,28,Crotone,Serie C - C,38,20,3,23
2020,Marcos Llorente,Central Midfield,25,Atlético Madrid,LaLiga,37,12,11,23
2020,Sasa Kalajdzic,Centre-Forward,22,VfB Stuttgart,Bundesliga,33,16,6,22
2020,Marcus Rashford,Left Winger,22,Man Utd,Premier League,37,11,11,22
2020,Burak Yilmaz,Centre-Forward,34,LOSC Lille,Ligue 1,28,16,5,21
2020,Karl Toko Ekambi,Centre-Forward,27,Olympique Lyon,Ligue 1,35,14,7,21
2020,Antoine Griezmann,Centre-Forward,29,Barcelona,LaLiga,36,13,8,21
2020,Álvaro Morata,Centre-Forward,27,Juventus,Serie A,32,11,10,21
2020,Filip Kostić,Left Midfield,27,E. Frankfurt,Bundesliga,30,4,17,21
2020,Ludovic Ajorque,Centre-Forward,26,R. Strasbourg,Ligue 1,35,16,4,20
2020,Andrea Belotti,Centre-Forward,26,Torino,Serie A,35,13,7,20
2020,Jadon Sancho,Left Winger,20,Bor. Dortmund,Bundesliga,26,8,12,20
2020,Ruslan Malinovskyi,Attacking Midfield,27,Atalanta BC,Serie A,36,8,12,20
2021,Kylian Mbappé,Centre-Forward,22,Paris SG,Ligue 1,35,28,19,47
2021,Robert Lewandowski,Centre-Forward,32,Bayern Munich,Bundesliga,34,35,4,39
2021,Karim Benzema,Centre-Forward,33,Real Madrid,LaLiga,32,27,12,39
2021,Mohamed Salah,Right Winger,29,Liverpool,Premier League,35,23,14,37
2021,Christopher Nkunku,Second Striker,23,RB Leipzig,Bundesliga,34,20,15,35
2021,Mehdi Taremi,Centre-Forward,28,FC Porto,Liga Portugal,32,20,13,33
2021,Heung-min Son,Left Winger,28,Tottenham,Premier League,35,23,9,32
2021,Domenico Berardi,Right Winger,26,Sassuolo,Serie A,33,15,17,32
2021,Ciro Immobile,Centre-Forward,31,Lazio,Serie A,31,27,3,30
2021,Darwin Núñez,Centre-Forward,22,Benfica,Liga Portugal,28,26,4,30
2021,Wissam Ben Yedder,Centre-Forward,30,Monaco,Ligue 1,37,25,5,30
2021,Erling Haaland,Centre-Forward,20,Bor. Dortmund,Bundesliga,24,22,8,30
2021,Vinicius Junior,Left Winger,20,Real Madrid,LaLiga,35,17,13,30
2021,Dušan Vlahović,Centre-Forward,21,Juventus,Serie A,36,24,5,29
2021,Patrik Schick,Centre-Forward,25,B. Leverkusen,Bundesliga,27,24,5,29
2021,Thomas Müller,Second Striker,31,Bayern Munich,Bundesliga,32,8,21,29
2021,Luis Díaz,Left Winger,24,Liverpool,Premier League,31,18,8,26
2021,Harry Kane,Centre-Forward,27,Tottenham,Premier League,37,17,9,26
2021,Martin Terrier,Left Winger,24,Stade Rennais,Ligue 1,37,21,4,25
2021,Moussa Dembélé,Centre-Forward,24,Olympique Lyon,Ligue 1,30,21,4,25
2021,Moussa Diaby,Right Winger,21,B. Leverkusen,Bundesliga,32,13,12,25
2021,Marco Reus,Attacking Midfield,32,Bor. Dortmund,Bundesliga,29,9,16,25
2021,Lautaro Martínez,Centre-Forward,23,Inter,Serie A,35,21,3,24
2021,Anthony Modeste,Centre-Forward,33,1.FC Köln,Bundesliga,32,20,4,24
2021,Ricardo Horta,Left Winger,26,SC Braga,Liga Portugal,32,19,5,24
2021,Iago Aspas,Centre-Forward,33,Celta de Vigo,LaLiga,37,18,6,24
2021,Pablo Sarabia,Right Winger,29,Paris SG,Ligue 1,31,16,8,24
2021,Jarrod Bowen,Right Winger,24,West Ham,Premier League,36,12,12,24
2021,Benjamin Bourigeaud,Central Midfield,27,Stade Rennais,Ligue 1,38,11,13,24
2021,Rafa,Left Winger,28,Benfica,Liga Portugal,28,8,16,24
2021,Giovanni Simeone,Centre-Forward,25,Cagliari Calcio,Serie A,36,17,6,23
2021,Kevin De Bruyne,Attacking Midfield,30,Man City,Premier League,30,15,8,23
2021,Gaëtan Laborde,Centre-Forward,27,Stade Rennais,Ligue 1,38,15,8,23
2021,Dimitri Payet,Attacking Midfield,34,Marseille,Ligue 1,31,12,10,22
2021,Sergej Milinkovic-Savic,Central Midfield,26,Lazio,Serie A,37,11,11,22
2021,Cristiano Ronaldo,Centre-Forward,36,Man Utd,Premier League,31,18,3,21
2021,Andy Delort,Centre-Forward,29,OGC Nice,Ligue 1,35,18,3,21
2021,Tammy Abraham,Centre-Forward,23,AS Roma,Serie A,37,17,4,21
2021,Juanmi,Left Winger,28,Real Betis,LaLiga,33,16,5,21
2021,Diogo Jota,Left Winger,24,Liverpool,Premier League,35,15,6,21
2021,Rafael Leão,Left Winger,22,AC Milan,Serie A,34,11,10,21
2021,Mason Mount,Attacking Midfield,22,Chelsea,Premier League,32,11,10,21
2021,Lionel Messi,Right Winger,34,Paris SG,Ligue 1,26,6,15,21
2021,Raúl de Tomás,Centre-Forward,26,Espanyol,LaLiga2,34,17,3,20
2021,Sadio Mané,Left Winger,29,Liverpool,Premier League,34,16,4,20
2021,Mario Pasalic,Attacking Midfield,26,Atalanta BC,Serie A,37,13,7,20
2021,Edin Dzeko,Centre-Forward,35,Inter,Serie A,36,13,7,20
2021,José Luis Morales,Centre-Forward,33,Levante,LaLiga2,35,13,7,20
2021,James Maddison,Attacking Midfield,24,Leicester,Championship,35,12,8,20
2021,Ludovic Ajorque,Centre-Forward,27,R. Strasbourg,Ligue 1,36,12,8,20
2022,Erling Haaland,Centre-Forward,21,Man City,Premier League,35,36,8,44
2022,Kylian Mbappé,Centre-Forward,23,Paris SG,Ligue 1,34,29,6,35
2022,Harry Kane,Centre-Forward,28,Tottenham,Premier League,38,30,3,33
2022,Alexandre Lacazette,Centre-Forward,31,Olympique Lyon,Ligue 1,35,27,5,32
2022,Lionel Messi,Right Winger,35,Paris SG,Ligue 1,32,16,16,32
2022,Antoine Griezmann,Centre-Forward,31,Atlético Madrid,LaLiga,38,15,17,32
2022,Victor Osimhen,Centre-Forward,23,SSC Napoli,Serie A,32,26,5,31
2022,Mohamed Salah,Right Winger,30,Liverpool,Premier League,38,19,12,31
2022,Robert Lewandowski,Centre-Forward,33,Barcelona,LaLiga,34,23,7,30
2022,Mehdi Taremi,Centre-Forward,29,FC Porto,Liga Portugal,33,22,8,30
2022,Randal Kolo Muani,Centre-Forward,23,E. Frankfurt,Bundesliga,32,15,14,29
2022,Jonathan David,Centre-Forward,22,LOSC Lille,Ligue 1,37,24,4,28
2022,Lautaro Martínez,Centre-Forward,24,Inter,Serie A,38,21,7,28
2022,Pedro Gonçalves,Right Winger,24,Sporting CP,Liga Portugal,33,15,12,27
2022,Gonçalo Ramos,Centre-Forward,21,Benfica,Liga Portugal,30,19,7,26
2022,João Mário,Central Midfield,29,Benfica,Liga Portugal,33,17,9,26
2022,Loïs Openda,Centre-Forward,22,Lens,Ligue 1,38,21,4,25
2022,Elye Wahi,Centre-Forward,19,Montpellier,Ligue 1,33,19,6,25
2022,Wissam Ben Yedder,Centre-Forward,31,Monaco,Ligue 1,32,19,6,25
2022,Rafael Leão,Left Winger,23,AC Milan,Serie A,35,15,10,25
2022,Bukayo Saka,Right Winger,20,Arsenal,Premier League,38,14,11,25
2022,Jamal Musiala,Attacking Midfield,19,Bayern Munich,Bundesliga,33,12,13,25
2022,Khvicha Kvaratskhelia,Left Winger,21,SSC Napoli,Serie A,34,12,13,25
2022,Kevin De Bruyne,Attacking Midfield,31,Man City,Premier League,32,7,18,25
2022,Folarin Balogun,Centre-Forward,20,Stade Reims,Ligue 1,37,21,3,24
2022,Ivan Toney,Centre-Forward,26,Brentford,Premier League,33,20,4,24
2022,Neymar,Left Winger,30,Paris SG,Ligue 1,20,13,11,24
2022,Callum Wilson,Centre-Forward,30,Newcastle,Premier League,31,18,5,23
2022,Martin Ødegaard,Attacking Midfield,23,Arsenal,Premier League,37,15,8,23
2022,Karim Benzema,Centre-Forward,34,Real Madrid,LaLiga,24,19,3,22
2022,Marcus Rashford,Left Winger,24,Man Utd,Premier League,35,17,5,22
2022,Christopher Nkunku,Second Striker,24,RB Leipzig,Bundesliga,25,16,6,22
2022,Boulaye Dia,Centre-Forward,25,Salernitana,Serie A,33,16,6,22
2022,Ricardo Horta,Left Winger,27,SC Braga,Liga Portugal,30,14,8,22
2022,Jonas Hofmann,Right Winger,29,Bor. M'gladbach,Bundesliga,31,12,10,22
2022,Habib Diallo,Centre-Forward,27,R. Strasbourg,Ligue 1,37,20,1,21
2022,Terem Moffi,Centre-Forward,23,FC Lorient,Ligue 1,34,18,3,21
2022,Niclas Füllkrug,Centre-Forward,29,Werder Bremen,Bundesliga,28,16,5,21
2022,Ollie Watkins,Centre-Forward,26,Aston Villa,Premier League,37,15,6,21
2022,Ademola Lookman,Second Striker,24,Atalanta BC,Serie A,31,13,8,21
2022,Leandro Trossard,Left Winger,27,Arsenal,Premier League,36,8,13,21
2022,Fran Navarro,Centre-Forward,24,Gil Vicente,Liga Portugal,34,17,3,20
2022,Gabriel Martinelli,Left Winger,21,Arsenal,Premier League,36,15,5,20
2022,Amine Gouiri,Centre-Forward,22,Stade Rennais,Ligue 1,36,15,5,20
2022,Vincenzo Grifo,Left Winger,29,SC Freiburg,Bundesliga,33,15,5,20
2022,Serge Gnabry,Right Winger,26,Bayern Munich,Bundesliga,34,14,6,20
2022,Vinicius Junior,Left Winger,21,Real Madrid,LaLiga,33,10,10,20
2022,Marcus Thuram,Centre-Forward,24,Bor. M'gladbach,Bundesliga,30,13,6,19
2022,Paulo Dybala,Second Striker,28,AS Roma,Serie A,25,12,7,19
2022,Domenico Berardi,Right Winger,27,Sassuolo,Serie A,26,12,7,19
2023,Serhou Guirassy,Centre-Forward,27,VfB Stuttgart,Bundesliga,5,10,1,11
2023,Erling Haaland,Centre-Forward,23,Man City,Premier League,5,7,1,8
2023,Kylian Mbappé,Centre-Forward,24,Paris SG,Ligue 1,4,7,0,7
2023,Lautaro Martínez,Centre-Forward,26,Inter,Serie A,4,5,2,7
2023,Róbert Bozeník,Centre-Forward,23,Boavista,Liga Portugal,5,5,2,7
2023,Xavi Simons,Right Winger,20,RB Leipzig,Bundesliga,4,3,4,7
2023,Jude Bellingham,Central Midfield,20,Real Madrid,LaLiga,5,5,1,6
2023,Jonas Wind,Centre-Forward,24,VfL Wolfsburg,Bundesliga,4,5,1,6
2023,Victor Boniface,Centre-Forward,22,B. Leverkusen,Bundesliga,4,4,2,6
2023,Ángel Di María,Right Winger,35,Benfica,Liga Portugal,5,4,2,6
2023,Olivier Giroud,Centre-Forward,36,AC Milan,Serie A,4,4,2,6
2023,Robert Lewandowski,Centre-Forward,35,Barcelona,LaLiga,5,3,3,6
2023,Rafa,Left Winger,30,Benfica,Liga Portugal,5,3,3,6
2023,Takumi Minamino,Left Winger,28,Monaco,Ligue 1,6,3,3,6
2023,Mohamed Salah,Right Winger,31,Liverpool,Premier League,5,2,4,6
2023,Julián Álvarez,Centre-Forward,23,Man City,Premier League,5,2,4,6
2023,Harry Kane,Centre-Forward,30,Bayern Munich,Bundesliga,4,4,1,5
2023,Dušan Vlahović,Centre-Forward,23,Juventus,Serie A,4,4,1,5
2023,Taiwo Awoniyi,Centre-Forward,26,Nottm Forest,Premier League,5,3,2,5
2023,Iñaki Williams,Centre-Forward,29,Athletic,LaLiga,6,3,2,5
2023,Terem Moffi,Centre-Forward,24,OGC Nice,Ligue 1,6,3,2,5
2023,Teddy Teuma,Central Midfield,29,Stade Reims,Ligue 1,5,3,2,5
2023,Romain Del Castillo,Right Winger,27,Stade Brestois,Ligue 1,5,3,2,5
2023,James Ward-Prowse,Central Midfield,28,West Ham,Premier League,4,2,3,5
2023,Marcus Thuram,Centre-Forward,26,Inter,Serie A,4,2,3,5
2023,Chris Führich,Left Winger,25,VfB Stuttgart,Bundesliga,5,2,3,5
2023,Jan-Niklas Beste,Left Winger,24,Heidenheim,Bundesliga,3,2,3,5
2023,Maxime Dominguez,Attacking Midfield,27,Gil Vicente,Liga Portugal,5,2,3,5
2023,Bryan Mbeumo,Right Winger,24,Brentford,Premier League,5,4,0,4
2023,Evan Ferguson,Centre-Forward,18,Brighton,Premier League,5,4,0,4
2023,Wissam Ben Yedder,Centre-Forward,33,Monaco,Ligue 1,6,4,0,4
2023,Odsonne Edouard,Centre-Forward,25,Crystal Palace,Premier League,5,4,0,4
2023,Paulinho,Centre-Forward,30,Sporting CP,Liga Portugal,5,4,0,4
2023,Mostafa Mohamed,Centre-Forward,25,FC Nantes,Ligue 1,5,4,0,4
2023,Kevin Behrens,Centre-Forward,32,Union Berlin,Bundesliga,4,4,0,4
2023,Jarrod Bowen,Right Winger,26,West Ham,Premier League,5,3,1,4
2023,Loïs Openda,Centre-Forward,23,RB Leipzig,Bundesliga,4,3,1,4
2023,Takefusa Kubo,Right Winger,22,Real Sociedad,LaLiga,5,3,1,4
2023,Viktor Gyökeres,Centre-Forward,25,Sporting CP,Liga Portugal,5,3,1,4
2023,Tomas Cvancara,Centre-Forward,23,Bor. M'gladbach,Bundesliga,4,3,1,4
2023,Hugo Duro,Centre-Forward,23,Valencia,LaLiga,5,3,1,4
2023,Maximilian Beier,Centre-Forward,20,TSG Hoffenheim,Bundesliga,4,3,1,4
2023,João Marques,Attacking Midfield,21,Estoril Praia,Liga Portugal,5,3,1,4
2023,Bukayo Saka,Right Winger,22,Arsenal,Premier League,5,2,2,4
2023,Rafael Leão,Left Winger,24,AC Milan,Serie A,4,2,2,4
2023,James Maddison,Attacking Midfield,26,Tottenham,Premier League,5,2,2,4
2023,Moussa Diaby,Right Winger,24,Aston Villa,Premier League,5,2,2,4
2023,Jean-Ricner Bellegarde,Central Midfield,25,Wolves,Premier League,4,2,2,4
2023,Andrea Belotti,Centre-Forward,29,AS Roma,Serie A,4,2,2,4
2023,Tim Kleindienst,Centre-Forward,28,Heidenheim,Bundesliga,4,2,2,4
